Protein,Protein ID,Entry Name,Gene,Protein Length,Organism,Protein Existence,Description,Protein Probability,Top Peptide Probability,Combined Total Peptides,Combined Spectral Count,Combined Unique Spectral Count,Combined Total Spectral Count,5dpf_1 Spectral Count,5dpf_2 Spectral Count,5dpf_1 Unique Spectral Count,5dpf_2 Unique Spectral Count,5dpf_1 Total Spectral Count,5dpf_2 Total Spectral Count,5dpf_1 Intensity,5dpf_2 Intensity,Indistinguishable Proteins
sp|A0A0G2KTI4|S12A2_DANRE,A0A0G2KTI4,S12A2_DANRE,slc12a2,1136,Danio rerio,1:Experimental evidence at protein level,Solute carrier family 12 member 2,1,0.999,15,28,28,28,16,12,16,12,16,12,837459650,616814340,
sp|A0A0R4I9Y1|R213B_DANRE,A0A0R4I9Y1,R213B_DANRE,rnf213b,5061,Danio rerio,3:Protein inferred from homology,E3 ubiquitin-protein ligase rnf213-beta,0.9896,0.9829,4,11,11,11,9,2,9,2,9,2,379784096,110018880,
sp|A0A0R4IB93|UBP48_DANRE,A0A0R4IB93,UBP48_DANRE,usp48,1047,Danio rerio,3:Protein inferred from homology,Ubiquitin carboxyl-terminal hydrolase 48,1,0.999,10,10,10,10,7,3,7,3,7,3,236048656,41750688,
sp|A0A0R4IBL7|HTF4_DANRE,A0A0R4IBL7,HTF4_DANRE,tcf12,726,Danio rerio,2:Experimental evidence at transcript level,Transcription factor 12,0.8058,0.993,1,1,1,1,1,0,1,0,1,0,29905182,0,
sp|A0A0R4IC37|CPSF1_DANRE,A0A0R4IC37,CPSF1_DANRE,cpsf1,1451,Danio rerio,3:Protein inferred from homology,Cleavage and polyadenylation specificity factor subunit 1,1,0.999,25,39,39,39,27,12,27,12,27,12,2239852030,456025952,
sp|A0A0R4IEW8|ELAV4_DANRE,A0A0R4IEW8,ELAV4_DANRE,elavl4,411,Danio rerio,1:Experimental evidence at protein level,ELAV-like protein 4,1,0.999,20,130,130,130,68,62,68,62,68,62,20952203300,17234782200,
sp|A0A0R4IFG5|CFA53_DANRE,A0A0R4IFG5,CFA53_DANRE,cfap53,519,Danio rerio,2:Experimental evidence at transcript level,Cilia- and flagella-associated protein 53,0.8009,0.9928,1,4,4,4,2,2,2,2,2,2,225050000,95131344,
sp|A0A0R4IKJ1|CAPAM_DANRE,A0A0R4IKJ1,CAPAM_DANRE,pcif1,721,Danio rerio,1:Experimental evidence at protein level,mRNA (2'-O-methyladenosine-N(6)-)-methyltransferase,0.9999,0.9986,3,5,5,5,3,2,3,2,3,2,139913616,63805408,
sp|A0A0R4IKU3|RECK_DANRE,A0A0R4IKU3,RECK_DANRE,reck,955,Danio rerio,1:Experimental evidence at protein level,Reversion-inducing cysteine-rich protein with Kazal motifs,1,0.999,22,35,35,35,20,15,20,15,20,15,1299377790,834574660,
sp|A0A0R4ITC5|TRRAP_DANRE,A0A0R4ITC5,TRRAP_DANRE,trrap,3841,Danio rerio,3:Protein inferred from homology,Transformation/transcription domain-associated protein,1,0.9971,10,12,12,12,6,6,6,6,6,6,490505312,1125510780,
sp|A0A0R4IVV0|MTP_DANRE,A0A0R4IVV0,MTP_DANRE,mttp,884,Danio rerio,1:Experimental evidence at protein level,Microsomal triglyceride transfer protein large subunit,1,0.999,48,242,242,242,133,109,133,109,133,109,18210820100,13254535200,
sp|A0A0R4IWI1|COE1A_DANRE,A0A0R4IWI1,COE1A_DANRE,ebf1a,591,Danio rerio,2:Experimental evidence at transcript level,Transcription factor COE1-A,1,0.999,5,13,7,13,7,6,4,3,7,6,641329340,430892096,
sp|A0A0R4IYX6|Z687A_DANRE,A0A0R4IYX6,Z687A_DANRE,znf687a,1246,Danio rerio,2:Experimental evidence at transcript level,Zinc finger protein 687a,0.9652,0.9989,2,1,1,2,1,0,1,0,2,0,30643374,0,
sp|A0A0R4IZ84|EST1A_DANRE,A0A0R4IZ84,EST1A_DANRE,smg6,1544,Danio rerio,2:Experimental evidence at transcript level,Telomerase-binding protein EST1A,0.7547,0.9905,1,1,1,1,1,0,1,0,1,0,55338720,0,
sp|A0A1Z2R986|EGLN_DANRE,A0A1Z2R986,EGLN_DANRE,eng,559,Danio rerio,2:Experimental evidence at transcript level,Endoglin,1,0.999,4,7,7,7,5,2,5,2,5,2,250941888,109214656,
sp|A0A286Y9D1|PHF14_DANRE,A0A286Y9D1,PHF14_DANRE,phf14,914,Danio rerio,1:Experimental evidence at protein level,PHD finger protein 14,0.6443,0.9841,1,1,1,1,1,0,1,0,1,0,26591018,0,
sp|A0A2R8Q3S9|CLCC1_DANRE,A0A2R8Q3S9,CLCC1_DANRE,clcc1,609,Danio rerio,2:Experimental evidence at transcript level,Chloride channel CLIC-like protein 1,0.9785,0.999,1,2,2,2,2,0,2,0,2,0,25130184,0,
sp|A0A2R8QCI3|DAPLE_DANRE,A0A2R8QCI3,DAPLE_DANRE,ccdc88c,2023,Danio rerio,2:Experimental evidence at transcript level,Protein Daple,1,0.9858,4,51,51,51,28,23,28,23,28,23,71519617000,53526041000,
sp|A0A2R8QF68|GRIK2_DANRE,A0A2R8QF68,GRIK2_DANRE,grik2,908,Danio rerio,3:Protein inferred from homology,"Glutamate receptor ionotropic, kainate 2",0.9999,0.9968,4,4,4,4,3,1,3,1,3,1,69983264,30649922,
sp|A0A2R8QFQ6|FB11A_DANRE,A0A2R8QFQ6,FB11A_DANRE,fbxw11a,562,Danio rerio,2:Experimental evidence at transcript level,F-box and WD repeat domain-containing 11-A,0.9997,0.9979,3,4,0,4,2,2,0,0,2,2,85608552,48217488,
sp|A0A2R8QP51|DPP9_DANRE,A0A2R8QP51,DPP9_DANRE,dpp9,885,Danio rerio,3:Protein inferred from homology,Dipeptidyl peptidase 9,1,0.999,27,77,77,77,42,35,42,35,42,35,3265288450,2325917700,
sp|A0A8M1N5Y4|TMX3A_DANRE,A0A8M1N5Y4,TMX3A_DANRE,tmx3a,437,Danio rerio,2:Experimental evidence at transcript level,Protein disulfide-isomerase tmx3a,1,0.9989,6,11,11,11,7,4,7,4,7,4,416246720,232805232,
sp|A0A8M1NHK4|RBM47_DANRE,A0A8M1NHK4,RBM47_DANRE,rbm47,600,Danio rerio,1:Experimental evidence at protein level,RNA-binding protein 47,0.9999,0.9958,4,6,6,6,3,3,3,3,3,3,255066720,130838920,
sp|A0A8M2B5N2|TSN18_DANRE,A0A8M2B5N2,TSN18_DANRE,tspan18b,258,Danio rerio,2:Experimental evidence at transcript level,Tetraspanin-18B,0.4517,0.9656,1,2,2,2,2,0,2,0,2,0,37703164,0,
sp|A0A8M2BIB6|DSG2L_DANRE,A0A8M2BIB6,DSG2L_DANRE,dsg2l,1063,Danio rerio,2:Experimental evidence at transcript level,Desmoglein-2-like protein,1,0.999,8,10,10,10,9,1,9,1,9,1,409769504,77941176,
sp|A0A8M2BID5|DESPA_DANRE,A0A8M2BID5,DESPA_DANRE,dspa,2059,Danio rerio,2:Experimental evidence at transcript level,Desmoplakin-A,1,0.999,86,208,204,208,107,101,105,99,107,101,9665986600,6281354200,
sp|A0A8M3AJY3|ABRX2_DANRE,A0A8M3AJY3,ABRX2_DANRE,abraxas2,416,Danio rerio,1:Experimental evidence at protein level,BRISC complex subunit abraxas 2,0.9992,0.9968,4,7,7,7,4,3,4,3,4,3,169969552,98616512,
sp|A0A8M3B525|BRCC3_DANRE,A0A8M3B525,BRCC3_DANRE,brcc3,287,Danio rerio,1:Experimental evidence at protein level,Lys-63-specific deubiquitinase,1,0.999,5,11,11,11,7,4,7,4,7,4,420606176,221523104,
sp|A0A8M9PFP2|CSTN3_DANRE,A0A8M9PFP2,CSTN3_DANRE,clstn3,956,Danio rerio,1:Experimental evidence at protein level,Calsyntenin-3,0.9985,0.9989,2,2,2,2,2,0,2,0,2,0,14951157,0,
sp|A0A8M9PQ61|DESPB_DANRE,A0A8M9PQ61,DESPB_DANRE,dspb,2207,Danio rerio,2:Experimental evidence at transcript level,Desmoplakin-B,1,0.999,91,194,194,198,113,81,113,81,115,83,8151835600,4724693000,
sp|A0AUR5|MINY3_DANRE,A0AUR5,MINY3_DANRE,mindy3,446,Danio rerio,2:Experimental evidence at transcript level,Ubiquitin carboxyl-terminal hydrolase MINDY-3,0.9999,0.999,2,4,4,4,2,2,2,2,2,2,131462016,65592784,
sp|A0AUS0|WSDU1_DANRE,A0AUS0,WSDU1_DANRE,wdsub1,487,Danio rerio,2:Experimental evidence at transcript level,"WD repeat, SAM and U-box domain-containing protein 1",1,0.999,4,6,6,6,3,3,3,3,3,3,32946542,26611146,
sp|A0JMD0|CLU_DANRE,A0JMD0,CLU_DANRE,cluh,1400,Danio rerio,2:Experimental evidence at transcript level,Clustered mitochondria protein homolog,1,0.999,36,87,87,87,46,41,46,41,46,41,4055414780,2959370750,
sp|A0JME2|MCAF1_DANRE,A0JME2,MCAF1_DANRE,atf7ip,815,Danio rerio,1:Experimental evidence at protein level,Activating transcription factor 7-interacting protein 1,0.9065,0.997,2,4,4,4,3,1,3,1,3,1,26472926,14299734,
sp|A0JME6|ISOC2_DANRE,A0JME6,ISOC2_DANRE,isoc2,197,Danio rerio,2:Experimental evidence at transcript level,Isochorismatase domain-containing protein 2,1,0.999,6,20,20,20,11,9,11,9,11,9,1496988290,1069750400,
sp|A0JMI9|RRF2M_DANRE,A0JMI9,RRF2M_DANRE,gfm2,762,Danio rerio,2:Experimental evidence at transcript level,"Ribosome-releasing factor 2, mitochondrial",0.9976,0.9984,5,6,6,6,5,1,5,1,5,1,137113952,27445602,
sp|A0JMK5|MTMR2_DANRE,A0JMK5,MTMR2_DANRE,mtmr2,620,Danio rerio,2:Experimental evidence at transcript level,"Phosphatidylinositol-3,5-bisphosphate 3-phosphatase MTMR2",1,0.999,10,23,23,23,14,9,14,9,14,9,3953136900,2539842560,
sp|A0JML8|DALD3_DANRE,A0JML8,DALD3_DANRE,dalrd3,558,Danio rerio,2:Experimental evidence at transcript level,DALR anticodon-binding domain-containing protein 3,0.753,0.9905,2,2,2,2,2,0,2,0,2,0,79831016,0,
sp|A0JMP0|PGGHG_DANRE,A0JMP0,PGGHG_DANRE,pgghg,655,Danio rerio,2:Experimental evidence at transcript level,Protein-glucosylgalactosylhydroxylysine glucosidase,1,0.999,5,7,7,7,4,3,4,3,4,3,250002256,170968512,
sp|A0MS83|ZN148_DANRE,A0MS83,ZN148_DANRE,znf148,808,Danio rerio,2:Experimental evidence at transcript level,Zinc finger protein 148,0.8506,0.9949,1,2,2,2,1,1,1,1,1,1,47785440,23587326,
sp|A0MTA1|APEX1_DANRE,A0MTA1,APEX1_DANRE,apex1,310,Danio rerio,1:Experimental evidence at protein level,DNA repair nuclease APEX1,1,0.999,21,73,73,73,39,34,39,34,39,34,5452295700,4262644990,
sp|A0PJR5|ECHD3_DANRE,A0PJR5,ECHD3_DANRE,echdc3,289,Danio rerio,2:Experimental evidence at transcript level,"Enoyl-CoA hydratase domain-containing protein 3, mitochondrial",0.9959,0.9962,4,5,5,5,4,1,4,1,4,1,608109440,96611000,
sp|A1A5H6|CNOT1_DANRE,A1A5H6,CNOT1_DANRE,cnot1,2374,Danio rerio,2:Experimental evidence at transcript level,CCR4-NOT transcription complex subunit 1,1,0.999,40,64,64,64,40,24,40,24,40,24,2543007740,1860999810,
sp|A1A5H8|YES_DANRE,A1A5H8,YES_DANRE,yes1,546,Danio rerio,1:Experimental evidence at protein level,Tyrosine-protein kinase yes,1,0.999,26,62,30,62,35,27,18,12,35,27,3669534720,3779495420,
sp|A1A5V7|TM41B_DANRE,A1A5V7,TM41B_DANRE,tmem41b,282,Danio rerio,2:Experimental evidence at transcript level,Transmembrane protein 41B,0.9893,0.9866,2,4,4,4,2,2,2,2,2,2,108007720,88504104,
sp|A1A5V9|ELP5_DANRE,A1A5V9,ELP5_DANRE,elp5,296,Danio rerio,2:Experimental evidence at transcript level,Elongator complex protein 5,0.9573,0.9987,1,1,1,1,1,0,1,0,1,0,40609156,0,
sp|A1A5Y0|NELL2_DANRE,A1A5Y0,NELL2_DANRE,nell2a,811,Danio rerio,2:Experimental evidence at transcript level,Protein kinase C-binding protein NELL2a,1,0.9989,8,16,16,16,10,6,10,6,10,6,396316096,271597504,
sp|A1A5Z3|EFTS_DANRE,A1A5Z3,EFTS_DANRE,tsfm,305,Danio rerio,2:Experimental evidence at transcript level,"Elongation factor Ts, mitochondrial",1,0.999,8,16,16,16,10,6,10,6,10,6,427967232,294789760,
sp|A1DZY4|RSLBL_DANRE,A1DZY4,RSLBL_DANRE,zgc:110179,253,Danio rerio,2:Experimental evidence at transcript level,Ras-like protein family member 11A-like,0.9062,0.9846,2,3,3,3,1,2,1,2,1,2,1717156.5,350608.97,
sp|A1IH00|GOGA2_DANRE,A1IH00,GOGA2_DANRE,golga2,1028,Danio rerio,2:Experimental evidence at transcript level,Golgin subfamily A member 2,0.9902,0.9965,3,4,4,4,1,3,1,3,1,3,86573576,87053760,
sp|A1L1F1|NDUF3_DANRE,A1L1F1,NDUF3_DANRE,ndufaf3,174,Danio rerio,2:Experimental evidence at transcript level,NADH dehydrogenase [ubiquinone] 1 alpha subcomplex assembly factor 3,0.9563,0.9987,1,1,1,1,1,0,1,0,1,0,20079432,0,
sp|A1L1F4|PDS5A_DANRE,A1L1F4,PDS5A_DANRE,pds5a,1320,Danio rerio,2:Experimental evidence at transcript level,Sister chromatid cohesion protein PDS5 homolog A,1,0.999,32,71,71,71,48,23,48,23,48,23,3210886910,1623283200,
sp|A1L1G1|ESRP1_DANRE,A1L1G1,ESRP1_DANRE,esrp1,714,Danio rerio,2:Experimental evidence at transcript level,Epithelial splicing regulatory protein 1,1,0.999,6,11,11,11,8,3,8,3,8,3,227194448,79490528,
sp|A1L1M4|P4R2B_DANRE,A1L1M4,P4R2B_DANRE,ppp4r2b,426,Danio rerio,1:Experimental evidence at protein level,Serine/threonine-protein phosphatase 4 regulatory subunit 2-B,0.9991,0.999,3,3,3,7,1,2,1,2,3,4,145272176,119640584,
sp|A1L1N5|HN1BA_DANRE,A1L1N5,HN1BA_DANRE,hnf1ba,559,Danio rerio,2:Experimental evidence at transcript level,Hepatocyte nuclear factor 1-beta-A,0.7842,0.992,1,1,0,1,1,0,0,0,1,0,15723468,0,sp|Q8UW00|HN1BB_DANRE
sp|A1L1P7|DNLZ_DANRE,A1L1P7,DNLZ_DANRE,dnlz,183,Danio rerio,2:Experimental evidence at transcript level,DNL-type zinc finger protein,0.9726,0.9955,2,3,3,3,2,1,2,1,2,1,63675612,39311672,
sp|A1L1P9|S47A1_DANRE,A1L1P9,S47A1_DANRE,slc47a1,590,Danio rerio,2:Experimental evidence at transcript level,Multidrug and toxin extrusion protein 1,0.9471,0.9962,2,2,2,2,2,0,2,0,2,0,21791064,0,
sp|A1L1R6|ZN423_DANRE,A1L1R6,ZN423_DANRE,znf423,1365,Danio rerio,2:Experimental evidence at transcript level,Zinc finger protein 423,1,0.999,12,20,20,20,13,7,13,7,13,7,636580860,291381376,
sp|A1L1V4|LOL2B_DANRE,A1L1V4,LOL2B_DANRE,loxl2b,762,Danio rerio,2:Experimental evidence at transcript level,Lysyl oxidase homolog 2B,0.4141,0.9601,1,1,1,1,0,1,0,1,0,1,0,0,
sp|A1L1W9|MOT10_DANRE,A1L1W9,MOT10_DANRE,slc16a10,505,Danio rerio,2:Experimental evidence at transcript level,Monocarboxylate transporter 10,0.3793,0.9542,1,1,1,1,1,0,1,0,1,0,9832262,0,
sp|A1L237|ENDUA_DANRE,A1L237,ENDUA_DANRE,endoua,303,Danio rerio,2:Experimental evidence at transcript level,Uridylate-specific endoribonuclease A,1,0.999,5,9,9,9,6,3,6,3,6,3,551868990,179150832,
sp|A1L243|MESD_DANRE,A1L243,MESD_DANRE,mesd,206,Danio rerio,2:Experimental evidence at transcript level,LRP chaperone MESD,1,0.999,7,22,22,22,13,9,13,9,13,9,1626743420,961986620,
sp|A1L244|SAC1B_DANRE,A1L244,SAC1B_DANRE,sacm1lb,586,Danio rerio,2:Experimental evidence at transcript level,Phosphatidylinositol-3-phosphatase SAC1-B,0.9997,0.9989,7,4,4,11,3,1,3,1,8,3,89009160,69240352,
sp|A1L251|ENASE_DANRE,A1L251,ENASE_DANRE,engase,713,Danio rerio,2:Experimental evidence at transcript level,Cytosolic endo-beta-N-acetylglucosaminidase,1,0.9987,4,6,6,6,4,2,4,2,4,2,277292288,87951288,
sp|A1L252|RANB9_DANRE,A1L252,RANB9_DANRE,ranbp9,597,Danio rerio,2:Experimental evidence at transcript level,Ran-binding protein 9,1,0.999,5,7,7,7,4,3,4,3,4,3,161746896,63434772,
sp|A1L258|D2HDH_DANRE,A1L258,D2HDH_DANRE,d2hgdh,533,Danio rerio,2:Experimental evidence at transcript level,"D-2-hydroxyglutarate dehydrogenase, mitochondrial",1,0.999,10,15,15,15,8,7,8,7,8,7,526939456,264568112,
sp|A1L259|URAD_DANRE,A1L259,URAD_DANRE,urad,174,Danio rerio,1:Experimental evidence at protein level,2-oxo-4-hydroxy-4-carboxy-5-ureidoimidazoline decarboxylase,0.4082,0.9592,1,1,1,1,1,0,1,0,1,0,34061604,0,
sp|A1L260|CVN4A_DANRE,A1L260,CVN4A_DANRE,cavin4a,329,Danio rerio,1:Experimental evidence at protein level,Caveolae-associated protein 4a,1,0.999,12,28,28,28,16,12,16,12,16,12,2496063230,1177672190,
sp|A1L271|GNB5A_DANRE,A1L271,GNB5A_DANRE,gnb5a,355,Danio rerio,2:Experimental evidence at transcript level,Guanine nucleotide-binding protein subunit beta-5a,1,0.9984,10,7,7,19,4,3,4,3,11,8,164724736,115717712,
sp|A1L2F6|TM205_DANRE,A1L2F6,TM205_DANRE,tmem205,188,Danio rerio,2:Experimental evidence at transcript level,Transmembrane protein 205,0.967,0.999,1,1,1,1,1,0,1,0,1,0,39706776,0,
sp|A1XQX0|NR1AA_DANRE,A1XQX0,NR1AA_DANRE,nrxn1a,1491,Danio rerio,2:Experimental evidence at transcript level,Neurexin-1a,1,0.999,22,43,28,43,23,20,16,12,23,20,1601315200,978538110,
sp|A1XQX8|NR3AA_DANRE,A1XQX8,NR3AA_DANRE,nrxn3a,1697,Danio rerio,2:Experimental evidence at transcript level,Neurexin-3a,1,0.999,11,10,10,21,4,6,4,6,11,10,210894736,497947520,
sp|A1XQY1|NR3BA_DANRE,A1XQY1,NR3BA_DANRE,nrxn3b,1686,Danio rerio,2:Experimental evidence at transcript level,Neurexin-3b,1,0.999,12,17,9,24,12,5,6,3,16,8,317852032,174030624,
sp|A1XQY3|NR3BB_DANRE,A1XQY3,NR3BB_DANRE,nrxn3b,675,Danio rerio,2:Experimental evidence at transcript level,Neurexin-3b-beta,0.946,0.9983,2,1,1,2,0,1,0,1,1,1,0,113955456,
sp|A2AV36|ANM7_DANRE,A2AV36,ANM7_DANRE,prmt7,683,Danio rerio,2:Experimental evidence at transcript level,Protein arginine N-methyltransferase 7,1,0.999,4,7,7,7,4,3,4,3,4,3,156493232,81263456,
sp|A2BEA6|ARI3A_DANRE,A2BEA6,ARI3A_DANRE,arid3a,570,Danio rerio,1:Experimental evidence at protein level,AT-rich interactive domain-containing protein 3A,0.922,0.9957,2,3,3,3,2,1,2,1,2,1,67200584,32436888,
sp|A2BG43|GLTP_DANRE,A2BG43,GLTP_DANRE,gltp,209,Danio rerio,3:Protein inferred from homology,Glycolipid transfer protein,1,0.9983,9,16,16,16,9,7,9,7,9,7,983746820,414820352,
sp|A2BGD5|CACO1_DANRE,A2BGD5,CACO1_DANRE,calcoco1,640,Danio rerio,3:Protein inferred from homology,Calcium-binding and coiled-coil domain-containing protein 1,1,0.999,5,7,7,7,4,3,4,3,4,3,177474688,56161264,
sp|A2BGG1|MTMRC_DANRE,A2BGG1,MTMRC_DANRE,mtmr12,736,Danio rerio,1:Experimental evidence at protein level,Myotubularin-related protein 12,0.938,0.9823,2,2,2,2,2,0,2,0,2,0,34001156,0,
sp|A2BGU8|SEPT3_DANRE,A2BGU8,SEPT3_DANRE,septin3,361,Danio rerio,2:Experimental evidence at transcript level,Neuronal-specific septin-3,1,0.999,14,30,30,30,19,11,19,11,19,11,1348999680,1156438400,
sp|A2BGU9|SERHL_DANRE,A2BGU9,SERHL_DANRE,serhl,326,Danio rerio,2:Experimental evidence at transcript level,Serine hydrolase-like protein,1,0.999,6,12,12,12,7,5,7,5,7,5,369470272,108397760,
sp|A2BHJ4|CNO6L_DANRE,A2BHJ4,CNO6L_DANRE,cnot6l,559,Danio rerio,2:Experimental evidence at transcript level,CCR4-NOT transcription complex subunit 6-like,0.9995,0.9988,1,4,4,4,2,2,2,2,2,2,134197272,77415728,
sp|A2BID7|PRD10_DANRE,A2BID7,PRD10_DANRE,prdm10,1121,Danio rerio,3:Protein inferred from homology,PR domain zinc finger protein 10,0.9981,0.9968,3,3,3,3,3,0,3,0,3,0,70774952,0,
sp|A2BIJ3|BSDC1_DANRE,A2BIJ3,BSDC1_DANRE,bsdc1,412,Danio rerio,1:Experimental evidence at protein level,BSD domain-containing protein 1,0.9944,0.999,2,2,2,2,2,0,2,0,2,0,70754904,0,
sp|A2BIL7|BAZ1B_DANRE,A2BIL7,BAZ1B_DANRE,baz1b,1536,Danio rerio,1:Experimental evidence at protein level,Tyrosine-protein kinase BAZ1B,1,0.9986,6,7,7,7,3,4,3,4,3,4,958628540,53283784,
sp|A2CEH0|POC1B_DANRE,A2CEH0,POC1B_DANRE,poc1b,490,Danio rerio,2:Experimental evidence at transcript level,POC1 centriolar protein homolog B,0.6287,0.9748,2,3,2,3,2,1,1,1,2,1,29726330,1374148.6,
sp|A2CEI4|NUP88_DANRE,A2CEI4,NUP88_DANRE,nup88,720,Danio rerio,1:Experimental evidence at protein level,Nucleoporin 88,1,0.9989,6,9,9,9,5,4,5,4,5,4,212066192,153999744,
sp|A2CEQ0|SCM2B_DANRE,A2CEQ0,SCM2B_DANRE,slc25a25b,469,Danio rerio,3:Protein inferred from homology,Calcium-binding mitochondrial carrier protein SCaMC-2-B,0.9669,0.999,1,1,1,1,1,0,1,0,1,0,7890727,0,
sp|A2CES0|NEUFC_DANRE,A2CES0,NEUFC_DANRE,cyb5d2,267,Danio rerio,3:Protein inferred from homology,Neuferricin,0.9943,0.999,2,3,3,3,2,1,2,1,2,1,77945160,45662332,
sp|A2RRV3|PATL1_DANRE,A2RRV3,PATL1_DANRE,patl1,765,Danio rerio,1:Experimental evidence at protein level,Protein PAT1 homolog 1,0.9181,0.9974,1,1,1,1,1,0,1,0,1,0,40247668,0,
sp|A2RRV9|NARFL_DANRE,A2RRV9,NARFL_DANRE,narfl,411,Danio rerio,2:Experimental evidence at transcript level,Cytosolic Fe-S cluster assembly factor narfl,1,0.999,9,12,12,12,8,4,8,4,8,4,360774496,169024240,
sp|A2RV01|DPH6_DANRE,A2RV01,DPH6_DANRE,dph6,255,Danio rerio,2:Experimental evidence at transcript level,Diphthine--ammonia ligase,0.9999,0.998,3,6,6,6,3,3,3,3,3,3,283248704,216632816,
sp|A2RV18|DI3L1_DANRE,A2RV18,DI3L1_DANRE,dis3l,1057,Danio rerio,2:Experimental evidence at transcript level,DIS3-like exonuclease 1,0.8337,0.9752,1,1,1,1,1,0,1,0,1,0,24506796,0,
sp|A2RV29|ZN346_DANRE,A2RV29,ZN346_DANRE,znf346,301,Danio rerio,2:Experimental evidence at transcript level,Zinc finger protein 346,1,0.999,10,54,54,54,29,25,29,25,29,25,5180588500,2875071230,
sp|A2T929|RXRAA_DANRE,A2T929,RXRAA_DANRE,rxraa,430,Danio rerio,2:Experimental evidence at transcript level,Retinoic acid receptor RXR-alpha-A,1,0.9988,9,12,0,12,9,3,0,0,9,3,319516416,74550112,"sp|Q90415|RXRAB_DANRE, sp|Q90416|RXRGA_DANRE"
sp|A2VD23|STM_DANRE,A2VD23,STM_DANRE,stm,613,Danio rerio,2:Experimental evidence at transcript level,Protein starmaker,1,0.999,7,20,20,20,13,7,13,7,13,7,885126660,357378624,
sp|A3KNL5|ATF1A_DANRE,A3KNL5,ATF1A_DANRE,atp5if1a,105,Danio rerio,3:Protein inferred from homology,"ATPase inhibitor A, mitochondrial",1,0.9988,7,29,29,29,17,12,17,12,17,12,1233911420,940828800,
sp|A3KNS2|CNPY3_DANRE,A3KNS2,CNPY3_DANRE,cnpy3,276,Danio rerio,2:Experimental evidence at transcript level,Protein canopy homolog 3,0.5008,0.9716,1,1,1,1,1,0,1,0,1,0,0,0,
sp|A3KP48|F162B_DANRE,A3KP48,F162B_DANRE,fam162b,155,Danio rerio,2:Experimental evidence at transcript level,Protein FAM162B,0.9996,0.998,4,6,6,6,4,2,4,2,4,2,185719296,91835656,
sp|A3KP59|RIOX1_DANRE,A3KP59,RIOX1_DANRE,riox1,544,Danio rerio,2:Experimental evidence at transcript level,Ribosomal oxygenase 1,0.9551,0.9939,2,2,2,2,1,1,1,1,1,1,15528034,0,
sp|A3KP74|SDHF2_DANRE,A3KP74,SDHF2_DANRE,sdhaf2,158,Danio rerio,2:Experimental evidence at transcript level,"Succinate dehydrogenase assembly factor 2, mitochondrial",0.9513,0.9954,2,3,3,3,2,1,2,1,2,1,264312720,28339414,
sp|A3KP77|OXND1_DANRE,A3KP77,OXND1_DANRE,oxnad1,270,Danio rerio,2:Experimental evidence at transcript level,Oxidoreductase NAD-binding domain-containing protein 1,1,0.999,5,8,8,8,4,4,4,4,4,4,789734400,517990496,
sp|A3KPA0|JAM3B_DANRE,A3KPA0,JAM3B_DANRE,jam3b,302,Danio rerio,1:Experimental evidence at protein level,Junctional adhesion molecule 3B,1,0.999,13,35,35,35,18,17,18,17,18,17,2984563200,2541827580,
sp|A3KPK0|AGO3_DANRE,A3KPK0,AGO3_DANRE,ago3,860,Danio rerio,3:Protein inferred from homology,Protein argonaute-3,1,0.999,34,105,105,105,55,50,55,50,55,50,7013784100,5294425100,
sp|A3KPN8|TTC38_DANRE,A3KPN8,TTC38_DANRE,ttc38,466,Danio rerio,3:Protein inferred from homology,Tetratricopeptide repeat protein 38,1,0.999,7,10,10,10,6,4,6,4,6,4,342878272,176695872,
sp|A3KPP3|MOG1_DANRE,A3KPP3,MOG1_DANRE,rangrf,183,Danio rerio,2:Experimental evidence at transcript level,Ran guanine nucleotide release factor,0.3835,0.955,1,1,1,1,1,0,1,0,1,0,34215912,0,
sp|A3KPQ7|CEIP2_DANRE,A3KPQ7,CEIP2_DANRE,cemip2,1378,Danio rerio,1:Experimental evidence at protein level,Cell surface hyaluronidase,1,0.999,14,23,23,23,14,9,14,9,14,9,676172350,453168896,
sp|A3KPW9|BAG6_DANRE,A3KPW9,BAG6_DANRE,Bag6,1160,Danio rerio,3:Protein inferred from homology,Large proline-rich protein BAG6,1,0.999,3,9,9,9,6,3,6,3,6,3,467017120,266923824,
sp|A3KQQ9|SCG3_DANRE,A3KQQ9,SCG3_DANRE,scg3,478,Danio rerio,2:Experimental evidence at transcript level,Secretogranin-3,1,0.999,6,15,15,15,7,8,7,8,7,8,753918400,574228030,
sp|A3KQS4|MINY1_DANRE,A3KQS4,MINY1_DANRE,mindy1,520,Danio rerio,3:Protein inferred from homology,Ubiquitin carboxyl-terminal hydrolase MINDY-1,0.9935,0.9976,2,3,3,3,2,1,2,1,2,1,96906728,42808728,
sp|A3KQV2|BROX_DANRE,A3KQV2,BROX_DANRE,brox,411,Danio rerio,2:Experimental evidence at transcript level,BRO1 domain-containing protein BROX,0.995,0.9734,5,8,8,8,5,3,5,3,5,3,411493216,250475040,
sp|A3QK15|AACS_DANRE,A3QK15,AACS_DANRE,aacs,673,Danio rerio,2:Experimental evidence at transcript level,Acetoacetyl-CoA synthetase,1,0.9975,7,11,11,11,7,4,7,4,7,4,312736256,124528720,
sp|A4FUM1|SEP8B_DANRE,A4FUM1,SEP8B_DANRE,sept8b,423,Danio rerio,2:Experimental evidence at transcript level,Septin-8-B,1,0.999,12,10,10,104,7,3,7,3,56,48,1081850880,210488272,
sp|A4IFW2|PTPRF_DANRE,A4IFW2,PTPRF_DANRE,ptprf,1909,Danio rerio,2:Experimental evidence at transcript level,Receptor-type tyrosine-protein phosphatase F,1,0.999,5,7,7,7,5,2,5,2,5,2,101690160,53644880,
sp|A4IG32|MICU1_DANRE,A4IG32,MICU1_DANRE,micu1,489,Danio rerio,2:Experimental evidence at transcript level,"Calcium uptake protein 1, mitochondrial",1,0.999,13,26,26,26,17,9,17,9,17,9,854276930,530295552,
sp|A4IG53|COMTB_DANRE,A4IG53,COMTB_DANRE,comtb,264,Danio rerio,2:Experimental evidence at transcript level,Catechol O-methyltransferase B,1,0.999,3,5,5,5,2,3,2,3,2,3,172239296,173118128,
sp|A4IG62|SUV3_DANRE,A4IG62,SUV3_DANRE,supv3l1,763,Danio rerio,2:Experimental evidence at transcript level,"ATP-dependent RNA helicase SUPV3L1, mitochondrial",1,0.999,6,8,8,8,4,4,4,4,4,4,330341536,133553968,
sp|A4IGF3|ATP23_DANRE,A4IGF3,ATP23_DANRE,atp23,254,Danio rerio,2:Experimental evidence at transcript level,Mitochondrial inner membrane protease ATP23 homolog,0.9994,0.9964,4,7,7,7,4,3,4,3,4,3,224946432,94534256,
sp|A4IGH4|WDR4_DANRE,A4IGH4,WDR4_DANRE,wdr4,413,Danio rerio,2:Experimental evidence at transcript level,tRNA (guanine-N(7)-)-methyltransferase non-catalytic subunit wdr4,1,0.999,10,15,15,15,9,6,9,6,9,6,494895264,291771936,
sp|A4QN59|DPH2_DANRE,A4QN59,DPH2_DANRE,dph2,498,Danio rerio,2:Experimental evidence at transcript level,2-(3-amino-3-carboxypropyl)histidine synthase subunit 2,1,0.9986,4,6,6,6,4,2,4,2,4,2,92024352,94053536,
sp|A4QNW7|PHIPL_DANRE,A4QNW7,PHIPL_DANRE,phyhipl,377,Danio rerio,2:Experimental evidence at transcript level,Phytanoyl-CoA hydroxylase-interacting protein-like,1,0.999,13,24,24,24,16,8,16,8,16,8,661347580,319149056,
sp|A4QP73|TTC19_DANRE,A4QP73,TTC19_DANRE,ttc19,403,Danio rerio,2:Experimental evidence at transcript level,"Tetratricopeptide repeat protein 19, mitochondrial",0.9665,0.999,1,1,1,1,1,0,1,0,1,0,21632374,0,
sp|A4QP78|CNO11_DANRE,A4QP78,CNO11_DANRE,cnot11,445,Danio rerio,2:Experimental evidence at transcript level,CCR4-NOT transcription complex subunit 11,0.965,0.9989,1,2,2,2,1,1,1,1,1,1,307124.1,2018983.4,
sp|A4VCH0|SAC1A_DANRE,A4VCH0,SAC1A_DANRE,sacm1la,586,Danio rerio,2:Experimental evidence at transcript level,Phosphatidylinositol-3-phosphatase SAC1-A,1,0.9988,10,16,9,16,9,7,4,5,9,7,479263040,239944320,
sp|A5D6U8|ACP7_DANRE,A5D6U8,ACP7_DANRE,acp7,443,Danio rerio,2:Experimental evidence at transcript level,Acid phosphatase type 7,1,0.9988,4,10,10,10,6,4,6,4,6,4,578435840,342137472,
sp|A5D8S8|HEXI1_DANRE,A5D8S8,HEXI1_DANRE,hexim1,319,Danio rerio,2:Experimental evidence at transcript level,Protein HEXIM1,0.7321,0.9894,1,2,2,2,1,1,1,1,1,1,81273512,86122640,
sp|A5HAK0|RNSL3_DANRE,A5HAK0,RNSL3_DANRE,rnasel3,149,Danio rerio,1:Experimental evidence at protein level,Ribonuclease-like 3,0.9581,0.9987,1,2,2,2,1,1,1,1,1,1,396152576,172540432,
sp|A5PF44|GARL3_DANRE,A5PF44,GARL3_DANRE,garnl3,1015,Danio rerio,3:Protein inferred from homology,GTPase-activating Rap/Ran-GAP domain-like protein 3,0.9999,0.999,4,6,6,6,4,2,4,2,4,2,167529920,99579208,
sp|A5PF48|MYO1C_DANRE,A5PF48,MYO1C_DANRE,myo1c,1026,Danio rerio,3:Protein inferred from homology,Unconventional myosin-Ic,1,0.9989,5,44,26,44,21,23,14,12,21,23,2221293310,1544852740,
sp|A5PF61|LEG1A_DANRE,A5PF61,LEG1A_DANRE,leg1a,364,Danio rerio,1:Experimental evidence at protein level,Protein leg1a,1,0.999,9,53,36,53,31,22,19,17,31,22,7734506000,7020870100,
sp|A5PL98|SDHB_DANRE,A5PL98,SDHB_DANRE,sdhb,280,Danio rerio,2:Experimental evidence at transcript level,"Succinate dehydrogenase [ubiquinone] iron-sulfur subunit, mitochondrial",1,0.999,21,104,104,104,56,48,56,48,56,48,9354221600,7160543700,
sp|A5PLC8|PTMAB_DANRE,A5PLC8,PTMAB_DANRE,ptmab,106,Danio rerio,1:Experimental evidence at protein level,Prothymosin alpha-B,1,0.999,6,186,186,186,108,78,108,78,108,78,54594077000,39344476000,
sp|A5PLK2|LHPP_DANRE,A5PLK2,LHPP_DANRE,lhpp,270,Danio rerio,2:Experimental evidence at transcript level,Phospholysine phosphohistidine inorganic pyrophosphate phosphatase,1,0.999,14,32,32,32,19,13,19,13,19,13,1711362430,1233926530,
sp|A5PMF6|GT251_DANRE,A5PMF6,GT251_DANRE,colgalt1,604,Danio rerio,3:Protein inferred from homology,Procollagen galactosyltransferase 1,1,0.9987,8,9,9,9,6,3,6,3,6,3,5875018200,74995208,
sp|A5PMU4|ANS1B_DANRE,A5PMU4,ANS1B_DANRE,anks1b,1280,Danio rerio,3:Protein inferred from homology,Ankyrin repeat and sterile alpha motif domain-containing protein 1B,0.999,0.9985,4,5,5,5,2,3,2,3,2,3,211544224,60098344,
sp|A5PMY6|COL12_DANRE,A5PMY6,COL12_DANRE,colec12,720,Danio rerio,2:Experimental evidence at transcript level,Collectin-12,0.9983,0.999,2,3,3,3,2,1,2,1,2,1,132057832,47028792,
sp|A5PN38|F151A_DANRE,A5PN38,F151A_DANRE,fam151a,599,Danio rerio,3:Protein inferred from homology,Protein FAM151A,0.973,0.9957,2,4,4,4,1,3,1,3,1,3,174130608,43256224,
sp|A5WVX0|ITPA_DANRE,A5WVX0,ITPA_DANRE,itpa,203,Danio rerio,2:Experimental evidence at transcript level,Inosine triphosphate pyrophosphatase,1,0.999,11,55,55,55,30,25,30,25,30,25,4332372000,3075039230,
sp|A5WVX1|EFNMT_DANRE,A5WVX1,EFNMT_DANRE,mettl13,690,Danio rerio,2:Experimental evidence at transcript level,eEF1A lysine and N-terminal methyltransferase,0.6572,0.9849,1,1,1,1,1,0,1,0,1,0,32908094,0,
sp|A5WVX9|ZDH17_DANRE,A5WVX9,ZDH17_DANRE,zdhhc17,620,Danio rerio,2:Experimental evidence at transcript level,Palmitoyltransferase ZDHHC17,0.9983,0.999,2,3,3,3,2,1,2,1,2,1,45724528,30026218,
sp|A5WWB6|ZWILC_DANRE,A5WWB6,ZWILC_DANRE,zwilch,583,Danio rerio,2:Experimental evidence at transcript level,Protein zwilch homolog,0.9951,0.999,2,2,2,2,1,1,1,1,1,1,30656952,21754092,
sp|A7E2M3|EMC10_DANRE,A7E2M3,EMC10_DANRE,emc10,257,Danio rerio,2:Experimental evidence at transcript level,ER membrane protein complex subunit 10,1,0.999,6,14,14,14,8,6,8,6,8,6,721884990,269038048,
sp|A7MBL8|PKN2_DANRE,A7MBL8,PKN2_DANRE,pkn2,977,Danio rerio,2:Experimental evidence at transcript level,Serine/threonine-protein kinase N2,1,0.9964,4,7,7,7,5,2,5,2,5,2,202480320,71962032,
sp|A7MBS7|THS7A_DANRE,A7MBS7,THS7A_DANRE,thsd7aa,1686,Danio rerio,1:Experimental evidence at protein level,Thrombospondin type-1 domain-containing protein 7A,1,0.9989,8,10,10,10,6,4,6,4,6,4,303144448,1263032060,
sp|A7Y7X5|ZN711_DANRE,A7Y7X5,ZN711_DANRE,znf711,761,Danio rerio,1:Experimental evidence at protein level,Zinc finger protein 711,0.7745,0.9915,1,1,1,1,1,0,1,0,1,0,19987176,0,
sp|A7YT82|NMT2_DANRE,A7YT82,NMT2_DANRE,nmt2,492,Danio rerio,2:Experimental evidence at transcript level,Glycylpeptide N-tetradecanoyltransferase 2,1,0.9988,7,12,12,12,8,4,8,4,8,4,314889600,181510944,
sp|A7YY97|CD37L_DANRE,A7YY97,CD37L_DANRE,cdc37l1,313,Danio rerio,2:Experimental evidence at transcript level,Hsp90 co-chaperone Cdc37-like 1,0.7114,0.9882,1,1,1,1,1,0,1,0,1,0,8865669,0,
sp|A8C984|MYLK3_DANRE,A8C984,MYLK3_DANRE,mylk3,715,Danio rerio,2:Experimental evidence at transcript level,Myosin light chain kinase 3,0.6624,0.9853,2,2,2,11,1,1,1,1,5,6,6375876.5,7355846,
sp|A8DZE6|WTIP_DANRE,A8DZE6,WTIP_DANRE,wtip,648,Danio rerio,3:Protein inferred from homology,Wilms tumor protein 1-interacting protein homolog,0.8538,0.995,1,2,2,2,1,1,1,1,1,1,84684496,64874676,
sp|A8E5C5|DS7CA_DANRE,A8E5C5,DS7CA_DANRE,dhrs7ca,324,Danio rerio,2:Experimental evidence at transcript level,Dehydrogenase/reductase SDR family member 7C-A,1,0.999,10,15,15,15,11,4,11,4,11,4,2763951360,391191360,
sp|A8E7C5|SAC2_DANRE,A8E7C5,SAC2_DANRE,inpp5f,1120,Danio rerio,3:Protein inferred from homology,Phosphatidylinositide phosphatase SAC2,1,0.9988,5,7,7,7,4,3,4,3,4,3,789456380,270840128,
sp|A8E7G4|DEN10_DANRE,A8E7G4,DEN10_DANRE,dennd10,349,Danio rerio,2:Experimental evidence at transcript level,DENN domain-containing protein 10,0.9265,0.9861,2,4,4,4,2,2,2,2,2,2,112987512,71883248,
sp|A8E7I5|TTC36_DANRE,A8E7I5,TTC36_DANRE,ttc36,187,Danio rerio,2:Experimental evidence at transcript level,Tetratricopeptide repeat protein 36,0.9951,0.9961,3,4,4,4,2,2,2,2,2,2,90306400,72814680,
sp|A8KB34|ACY2_DANRE,A8KB34,ACY2_DANRE,aspa,315,Danio rerio,2:Experimental evidence at transcript level,Aspartoacylase,1,0.999,7,12,12,12,7,5,7,5,7,5,401511616,128657456,
sp|A8KBL7|MET2A_DANRE,A8KBL7,MET2A_DANRE,mettl2a,353,Danio rerio,2:Experimental evidence at transcript level,tRNA N(3)-methylcytidine methyltransferase METTL2,0.984,0.9794,1,5,5,5,1,4,1,4,1,4,0,974756.94,
sp|A8WE67|KBP_DANRE,A8WE67,KBP_DANRE,kifbp,631,Danio rerio,2:Experimental evidence at transcript level,KIF-binding protein,1,0.999,11,16,16,16,11,5,11,5,11,5,399235680,252446528,
sp|A8WFR0|LAMP5_DANRE,A8WFR0,LAMP5_DANRE,lamp5,275,Danio rerio,2:Experimental evidence at transcript level,Lysosome-associated membrane glycoprotein 5,1,0.999,4,9,9,9,5,4,5,4,5,4,380700928,165940640,
sp|A8WG57|HMGC2_DANRE,A8WG57,HMGC2_DANRE,hmgcll1,335,Danio rerio,2:Experimental evidence at transcript level,"3-hydroxy-3-methylglutaryl-CoA lyase, cytoplasmic",0.9647,0.9989,1,2,2,2,1,1,1,1,1,1,95703120,57229768,
sp|A8WG88|TMX2A_DANRE,A8WG88,TMX2A_DANRE,tmx2a,301,Danio rerio,2:Experimental evidence at transcript level,Thioredoxin-related transmembrane protein 2-A,0.9612,0.9988,1,1,1,1,1,0,1,0,1,0,24741086,0,
sp|A8WGA0|C27C1_DANRE,A8WGA0,C27C1_DANRE,cyp27c1,540,Danio rerio,1:Experimental evidence at protein level,Cytochrome P450 27C1,0.5826,0.9794,1,1,1,1,0,1,0,1,0,1,0,66776936,
sp|A8WGP3|PP4CA_DANRE,A8WGP3,PP4CA_DANRE,ppp4ca,311,Danio rerio,2:Experimental evidence at transcript level,Serine/threonine-protein phosphatase 4 catalytic subunit A,0.9977,0.999,9,2,2,55,1,1,1,1,28,27,51973224,32542374,
sp|A8WHR3|YJU2_DANRE,A8WHR3,YJU2_DANRE,yju2,345,Danio rerio,1:Experimental evidence at protein level,Splicing factor YJU2,1,0.999,5,11,11,11,5,6,5,6,5,6,345981248,191124992,
sp|A8Y5U1|RIMC1_DANRE,A8Y5U1,RIMC1_DANRE,rimoc1,276,Danio rerio,2:Experimental evidence at transcript level,RAB7A-interacting MON1-CCZ1 complex subunit 1,0.9783,0.996,2,3,3,3,2,1,2,1,2,1,96794352,67120936,
sp|A9C3P0|MLEC_DANRE,A9C3P0,MLEC_DANRE,mlec,285,Danio rerio,3:Protein inferred from homology,Malectin,1,0.999,16,82,82,82,44,38,44,38,44,38,11614551000,4133533950,
sp|A9C3R9|RP65B_DANRE,A9C3R9,RP65B_DANRE,rpe65b,532,Danio rerio,1:Experimental evidence at protein level,All-trans-retinyl ester 13-cis isomerohydrolase,1,0.999,17,62,23,62,32,30,12,11,32,30,3203492100,1988301180,
sp|A9JRB3|HTR1B_DANRE,A9JRB3,HTR1B_DANRE,htra1b,476,Danio rerio,2:Experimental evidence at transcript level,Serine protease HTRA1B,0.9996,0.9986,1,2,0,2,2,0,0,0,2,0,66914064,0,
sp|A9JRC7|PP4CB_DANRE,A9JRC7,PP4CB_DANRE,ppp4cb,307,Danio rerio,2:Experimental evidence at transcript level,Serine/threonine-protein phosphatase 4 catalytic subunit B,1,0.999,14,73,20,73,38,35,11,9,38,35,7405800400,5071722500,
sp|A9JRE2|MTNA_DANRE,A9JRE2,MTNA_DANRE,mri1,353,Danio rerio,2:Experimental evidence at transcript level,Methylthioribose-1-phosphate isomerase,1,0.999,15,39,39,39,19,20,19,20,19,20,1196908800,1632063490,
sp|A9JRZ0|SMUF2_DANRE,A9JRZ0,SMUF2_DANRE,smurf2,765,Danio rerio,2:Experimental evidence at transcript level,E3 ubiquitin-protein ligase SMURF2,1,0.9988,4,5,5,5,4,1,4,1,4,1,555431300,57488588,
sp|A9JTG5|HOIL1_DANRE,A9JTG5,HOIL1_DANRE,rbck1,714,Danio rerio,2:Experimental evidence at transcript level,RanBP-type and C3HC4-type zinc finger-containing protein 1,0.9609,0.9911,3,5,5,5,2,3,2,3,2,3,56855928,33855892,
sp|A9JTH1|NCLDA_DANRE,A9JTH1,NCLDA_DANRE,ncalda,193,Danio rerio,2:Experimental evidence at transcript level,Neurocalcin-delta A,1,0.999,11,113,48,113,62,51,26,22,62,51,18053382100,10941623300,
sp|B0JZP3|THEM6_DANRE,B0JZP3,THEM6_DANRE,them6,202,Danio rerio,2:Experimental evidence at transcript level,Protein THEM6,0.9891,0.9898,3,5,5,5,3,2,3,2,3,2,176792320,117420464,
sp|B0R0D7|COR1C_DANRE,B0R0D7,COR1C_DANRE,coro1ca,474,Danio rerio,2:Experimental evidence at transcript level,Coronin-1C-A,1,0.999,33,154,154,154,83,71,83,71,83,71,14783887400,7860202000,
sp|B0R0I6|CHD8_DANRE,B0R0I6,CHD8_DANRE,chd8,2511,Danio rerio,3:Protein inferred from homology,Chromodomain-helicase-DNA-binding protein 8,0.8787,0.987,1,3,3,3,2,1,2,1,2,1,32276492,13662175,
sp|B0R0T1|VWA8_DANRE,B0R0T1,VWA8_DANRE,vwa8,1896,Danio rerio,3:Protein inferred from homology,von Willebrand factor A domain-containing protein 8,1,0.9958,6,8,8,8,5,3,5,3,5,3,205700160,31839870,
sp|B0R0W9|TBC8B_DANRE,B0R0W9,TBC8B_DANRE,tbc1d8b,1108,Danio rerio,1:Experimental evidence at protein level,TBC1 domain family member 8B,0.6797,0.9864,1,1,1,1,1,0,1,0,1,0,525652544,0,
sp|B0S5G3|CSTN2_DANRE,B0S5G3,CSTN2_DANRE,clstn2a,937,Danio rerio,1:Experimental evidence at protein level,Calsyntenin-2,0.9926,0.9912,2,4,4,4,3,1,3,1,3,1,184370896,89751464,
sp|B0S5N4|PLXA3_DANRE,B0S5N4,PLXA3_DANRE,plxna3,1892,Danio rerio,2:Experimental evidence at transcript level,Plexin A3,1,0.999,34,66,51,66,44,22,35,16,44,22,2880202500,1343722880,
sp|B0S6C5|RTSTL_DANRE,B0S6C5,RTSTL_DANRE,retsatl,604,Danio rerio,1:Experimental evidence at protein level,"Inactive all-trans-retinol 13,14-reductase",1,0.999,22,64,64,64,39,25,39,25,39,25,6224490000,3433935100,
sp|B0S6J3|SRGP2_DANRE,B0S6J3,SRGP2_DANRE,srgap2,1100,Danio rerio,2:Experimental evidence at transcript level,SLIT-ROBO Rho GTPase-activating protein 2,0.9758,0.9844,2,2,2,2,2,0,2,0,2,0,140525632,0,
sp|B0S6R1|NCKP1_DANRE,B0S6R1,NCKP1_DANRE,nckap1,1128,Danio rerio,3:Protein inferred from homology,Nck-associated protein 1,1,0.999,25,41,41,41,21,20,21,20,21,20,1413127300,1383781630,
sp|B0UXP9|IMDH2_DANRE,B0UXP9,IMDH2_DANRE,impdh2,514,Danio rerio,3:Protein inferred from homology,Inosine-5'-monophosphate dehydrogenase 2,1,0.999,17,44,44,47,25,19,25,19,26,21,2524765700,1462830080,
sp|B0V0U5|URB2_DANRE,B0V0U5,URB2_DANRE,urb2,1495,Danio rerio,2:Experimental evidence at transcript level,Unhealthy ribosome biogenesis protein 2 homolog,0.9233,0.9921,1,1,1,1,0,1,0,1,0,1,0,0,
sp|B0V3F8|PRKRA_DANRE,B0V3F8,PRKRA_DANRE,prkra,282,Danio rerio,2:Experimental evidence at transcript level,Interferon-inducible double-stranded RNA-dependent protein kinase activator A homolog,1,0.999,17,61,61,61,31,30,31,30,31,30,3883525120,3213018880,
sp|B0V3H4|ACTMP_DANRE,B0V3H4,ACTMP_DANRE,actmap,307,Danio rerio,2:Experimental evidence at transcript level,Actin maturation protease,0.9813,0.9975,2,2,2,2,1,1,1,1,1,1,26652880,60818864,
sp|B2ZGJ1|CLAT_DANRE,B2ZGJ1,CLAT_DANRE,chat,637,Danio rerio,2:Experimental evidence at transcript level,Choline O-acetyltransferase,1,0.999,6,6,6,6,6,0,6,0,6,0,587646340,0,
sp|B3DFW5|STMP1_DANRE,B3DFW5,STMP1_DANRE,stmp1,46,Danio rerio,2:Experimental evidence at transcript level,Short transmembrane mitochondrial protein 1,0.5259,0.9742,1,2,2,2,1,1,1,1,1,1,163223632,77595104,
sp|B3DIV9|KL40A_DANRE,B3DIV9,KL40A_DANRE,klhl40a,612,Danio rerio,2:Experimental evidence at transcript level,Kelch-like protein 40a,1,0.999,7,5,5,12,4,1,4,1,8,4,77846576,46941016,
sp|B3DJK0|TM160_DANRE,B3DJK0,TM160_DANRE,tmem160,208,Danio rerio,2:Experimental evidence at transcript level,Transmembrane protein 160,0.9104,0.9922,2,3,3,3,2,1,2,1,2,1,99712584,52187888,
sp|B3DJT0|SART3_DANRE,B3DJT0,SART3_DANRE,sart3,951,Danio rerio,2:Experimental evidence at transcript level,Squamous cell carcinoma antigen recognized by T-cells 3,1,0.999,28,69,69,69,37,32,37,32,37,32,3182673660,1891202430,
sp|B5DE31|YBOX1_DANRE,B5DE31,YBOX1_DANRE,ybx1,310,Danio rerio,1:Experimental evidence at protein level,Y-box-binding protein 1,1,0.999,10,55,55,55,30,25,30,25,30,25,6547824100,5047890400,
sp|B7ZC77|CTNA2_DANRE,B7ZC77,CTNA2_DANRE,Ctnna2,865,Danio rerio,3:Protein inferred from homology,Catenin alpha-2,1,0.999,39,83,83,139,48,35,48,35,75,64,4857439200,2400023810,
sp|B8A4W9|LOX3B_DANRE,B8A4W9,LOX3B_DANRE,loxl3b,807,Danio rerio,2:Experimental evidence at transcript level,Lysyl oxidase homolog 3B,1,0.999,4,5,5,5,3,2,3,2,3,2,127990944,83064928,
sp|B8A556|DNPH1_DANRE,B8A556,DNPH1_DANRE,dnph1,143,Danio rerio,3:Protein inferred from homology,5-hydroxymethyl-dUMP N-hydrolase,1,0.999,3,9,9,9,5,4,5,4,5,4,596585920,644358340,
sp|B8A5G9|TRM5_DANRE,B8A5G9,TRM5_DANRE,trmt5,480,Danio rerio,3:Protein inferred from homology,tRNA (guanine(37)-N1)-methyltransferase,1,0.999,15,23,23,23,14,9,14,9,14,9,839407740,316600768,
sp|B8A5I7|SSBP_DANRE,B8A5I7,SSBP_DANRE,ssbp1,146,Danio rerio,1:Experimental evidence at protein level,"Single-stranded DNA-binding protein, mitochondrial",1,0.999,12,46,46,46,29,17,29,17,29,17,3681737980,2144348160,
sp|B8JLQ9|CBPO_DANRE,B8JLQ9,CBPO_DANRE,cpo,363,Danio rerio,1:Experimental evidence at protein level,Carboxypeptidase O,1,0.999,7,18,18,18,8,10,8,10,8,10,1194090500,1066616700,
sp|B8JLV7|VMA21_DANRE,B8JLV7,VMA21_DANRE,vma21,104,Danio rerio,3:Protein inferred from homology,Vacuolar ATPase assembly integral membrane protein vma21,0.3807,0.9544,1,1,1,1,1,0,1,0,1,0,39863932,0,
sp|B8JMH0|CAF17_DANRE,B8JMH0,CAF17_DANRE,iba57,354,Danio rerio,3:Protein inferred from homology,"Putative transferase CAF17 homolog, mitochondrial",1,0.999,7,12,12,12,8,4,8,4,8,4,329124192,169750960,
sp|B8XY56|RNT2_DANRE,B8XY56,RNT2_DANRE,rnaset2,240,Danio rerio,2:Experimental evidence at transcript level,Ribonuclease T2,1,0.999,9,49,49,49,28,21,28,21,28,21,3511524860,2633340930,
sp|C6KFA3|AGRG6_DANRE,C6KFA3,AGRG6_DANRE,adgrg6,1185,Danio rerio,1:Experimental evidence at protein level,Adhesion G-protein coupled receptor G6,0.689,0.9869,2,2,2,2,1,1,1,1,1,1,351875392,0,
sp|E7EZF3|UHRF1_DANRE,E7EZF3,UHRF1_DANRE,uhrf1,776,Danio rerio,1:Experimental evidence at protein level,E3 ubiquitin-protein ligase UHRF1,1,0.999,6,13,13,13,7,6,7,6,7,6,265235456,123734312,
sp|E7F1H9|YTHD2_DANRE,E7F1H9,YTHD2_DANRE,ythdf2,613,Danio rerio,1:Experimental evidence at protein level,YTH domain-containing family protein 2,1,0.999,9,24,24,24,12,12,12,12,12,12,1727276800,1036011520,
sp|E7F3I6|CLP1_DANRE,E7F3I6,CLP1_DANRE,clp1,443,Danio rerio,1:Experimental evidence at protein level,Polyribonucleotide 5'-hydroxyl-kinase Clp1,1,0.999,8,12,12,12,8,4,8,4,8,4,345807552,154174112,
sp|E7F590|VPS41_DANRE,E7F590,VPS41_DANRE,vps41,854,Danio rerio,1:Experimental evidence at protein level,Vacuolar protein sorting-associated protein 41 homolog,0.9999,0.9981,3,4,4,4,2,2,2,2,2,2,64975368,192567840,
sp|E7F6F7|ABCB7_DANRE,E7F6F7,ABCB7_DANRE,abcb7,743,Danio rerio,3:Protein inferred from homology,"Iron-sulfur clusters transporter ABCB7, mitochondrial",0.9986,0.9958,3,4,4,4,2,2,2,2,2,2,1849641.4,3453223.5,
sp|E7F6H7|DCI2A_DANRE,E7F6H7,DCI2A_DANRE,dync1i2a,626,Danio rerio,3:Protein inferred from homology,"Dynein, cytoplasmic 1, intermediate chain 2a",1,0.999,8,21,21,21,10,11,10,11,10,11,1521500800,866767550,
sp|E7F9L8|MYO1D_DANRE,E7F9L8,MYO1D_DANRE,myo1d,1004,Danio rerio,2:Experimental evidence at transcript level,Unconventional myosin-Id,0.9978,0.9977,5,6,6,24,4,2,4,2,11,13,228616992,9488968,
sp|E7F9T0|MICA1_DANRE,E7F9T0,MICA1_DANRE,mical1,1214,Danio rerio,3:Protein inferred from homology,[F-actin]-monooxygenase mical1,0.9653,0.9989,1,1,1,1,1,0,1,0,1,0,32582248,0,
sp|E7FBU4|MMS19_DANRE,E7FBU4,MMS19_DANRE,mms19,1043,Danio rerio,3:Protein inferred from homology,MMS19 nucleotide excision repair protein homolog,1,0.9989,3,3,3,3,2,1,2,1,2,1,25329554,43565652,
sp|E7FBY6|AGRA2_DANRE,E7FBY6,AGRA2_DANRE,adgra2,1367,Danio rerio,1:Experimental evidence at protein level,Adhesion G protein-coupled receptor A2,0.3859,0.9554,1,1,1,1,0,1,0,1,0,1,0,9223033,
sp|E7FC72|EXOC7_DANRE,E7FC72,EXOC7_DANRE,exoc7,720,Danio rerio,3:Protein inferred from homology,Exocyst complex component 7,0.9652,0.9989,1,1,1,1,1,0,1,0,1,0,20567144,0,
sp|E7FDX5|LBX1B_DANRE,E7FDX5,LBX1B_DANRE,lbx1b,265,Danio rerio,2:Experimental evidence at transcript level,Transcription factor LBX1b,0.4726,0.9683,1,1,1,1,0,1,0,1,0,1,0,0,
sp|E7FF10|VWA1_DANRE,E7FF10,VWA1_DANRE,vwa1,503,Danio rerio,3:Protein inferred from homology,von Willebrand factor A domain-containing protein 1,0.9932,0.9956,2,3,3,3,2,1,2,1,2,1,100630160,8125139,
sp|E7FGY2|GID8B_DANRE,E7FGY2,GID8B_DANRE,gid8b,229,Danio rerio,2:Experimental evidence at transcript level,Glucose-induced degradation protein 8-B homolog,0.9999,0.999,4,6,2,6,3,3,1,1,3,3,77891328,58600992,
sp|E9QG68|UBP45_DANRE,E9QG68,UBP45_DANRE,usp45,803,Danio rerio,2:Experimental evidence at transcript level,Ubiquitin carboxyl-terminal hydrolase 45,0.5288,0.9745,1,2,2,2,1,1,1,1,1,1,4624537.5,1126076.6,
sp|E9QHT9|PERP_DANRE,E9QHT9,PERP_DANRE,perp,185,Danio rerio,2:Experimental evidence at transcript level,p53 apoptosis effector related to PMP-22,1,0.9981,3,15,15,15,8,7,8,7,8,7,1098483710,489070560,
sp|E9QI36|HARS1_DANRE,E9QI36,HARS1_DANRE,hars,513,Danio rerio,3:Protein inferred from homology,Histidine--tRNA ligase,1,0.999,30,80,70,80,48,32,43,27,48,32,3970528510,3337460740,
sp|E9QIN8|KL41A_DANRE,E9QIN8,KL41A_DANRE,klhl41a,599,Danio rerio,2:Experimental evidence at transcript level,Kelch-like protein 41a,1,0.999,10,16,14,29,9,7,8,6,16,13,643278720,390096576,
sp|E9QJ30|KL40B_DANRE,E9QJ30,KL40B_DANRE,klhl40b,618,Danio rerio,2:Experimental evidence at transcript level,Kelch-like protein 40b,1,0.999,17,32,27,32,21,11,18,9,21,11,1825778690,906936450,
sp|F1Q575|NNRD_DANRE,F1Q575,NNRD_DANRE,naxd,330,Danio rerio,3:Protein inferred from homology,ATP-dependent (S)-NAD(P)H-hydrate dehydratase,1,0.999,15,49,49,49,32,17,32,17,32,17,5967352300,3659826690,
sp|F1Q749|DKC1_DANRE,F1Q749,DKC1_DANRE,dkc1,506,Danio rerio,2:Experimental evidence at transcript level,H/ACA ribonucleoprotein complex subunit DKC1,1,0.999,15,24,24,24,14,10,14,10,14,10,908558270,566510850,
sp|F1Q8W0|CATIN_DANRE,F1Q8W0,CATIN_DANRE,cactin,835,Danio rerio,2:Experimental evidence at transcript level,Splicing factor Cactin,1,0.9984,6,6,6,6,6,0,6,0,6,0,217132896,0,
sp|F1Q8X5|FERM2_DANRE,F1Q8X5,FERM2_DANRE,fermt2,684,Danio rerio,2:Experimental evidence at transcript level,Fermitin family homolog 2,1,0.999,28,52,52,52,33,19,33,19,33,19,2196008960,1168516990,
sp|F1QAJ4|GATA_DANRE,F1QAJ4,GATA_DANRE,qrsl1,536,Danio rerio,2:Experimental evidence at transcript level,"Glutamyl-tRNA(Gln) amidotransferase subunit A, mitochondrial",0.3812,0.9545,1,1,1,1,0,1,0,1,0,1,0,48334176,
sp|F1QB54|PABPA_DANRE,F1QB54,PABPA_DANRE,pabpc1a,634,Danio rerio,1:Experimental evidence at protein level,Polyadenylate-binding protein 1A,1,0.999,52,439,439,439,237,202,237,202,237,202,58054918000,40383193000,
sp|F1QBY1|NIPLB_DANRE,F1QBY1,NIPLB_DANRE,nipblb,2876,Danio rerio,2:Experimental evidence at transcript level,Nipped-B-like protein B,1,0.9971,6,8,2,8,4,4,1,1,4,4,76680968,209470752,
sp|F1QC17|EMI1A_DANRE,F1QC17,EMI1A_DANRE,emilin1a,1014,Danio rerio,3:Protein inferred from homology,EMILIN-1-A,1,0.999,18,28,28,28,15,13,15,13,15,13,679811460,359018784,
sp|F1QC45|XRP2_DANRE,F1QC45,XRP2_DANRE,rp2,376,Danio rerio,1:Experimental evidence at protein level,Protein XRP2,1,0.999,11,24,24,24,14,10,14,10,14,10,936123580,467550880,
sp|F1QCC6|GPC1_DANRE,F1QCC6,GPC1_DANRE,gpc1,554,Danio rerio,2:Experimental evidence at transcript level,Glypican-1,1,0.999,12,22,22,22,14,8,14,8,14,8,1210205180,626613630,
sp|F1QCN0|GAL3A_DANRE,F1QCN0,GAL3A_DANRE,gatd3,262,Danio rerio,3:Protein inferred from homology,"Glutamine amidotransferase-like class 1 domain-containing protein 3, mitochondrial",1,0.999,11,28,28,28,16,12,16,12,16,12,875806780,786060100,
sp|F1QCV2|HDA10_DANRE,F1QCV2,HDA10_DANRE,hdac10,675,Danio rerio,1:Experimental evidence at protein level,Polyamine deacetylase HDAC10,1,0.999,25,67,67,67,42,25,42,25,42,25,2646080000,1482953090,
sp|F1QEB7|WDR11_DANRE,F1QEB7,WDR11_DANRE,wdr11,1239,Danio rerio,2:Experimental evidence at transcript level,WD repeat-containing protein 11,1,0.999,24,43,43,43,24,19,24,19,24,19,872683140,519791168,
sp|F1QEG2|KL41B_DANRE,F1QEG2,KL41B_DANRE,klhl41b,605,Danio rerio,2:Experimental evidence at transcript level,Kelch-like protein 41b,1,0.999,37,132,119,132,71,61,64,55,71,61,9717688300,6717382700,
sp|F1QFS9|UBP13_DANRE,F1QFS9,UBP13_DANRE,usp13,860,Danio rerio,2:Experimental evidence at transcript level,Ubiquitin carboxyl-terminal hydrolase 13,1,0.9988,7,13,13,13,9,4,9,4,9,4,571069060,336157600,
sp|F1QGC8|DTD1_DANRE,F1QGC8,DTD1_DANRE,dtd1,207,Danio rerio,1:Experimental evidence at protein level,D-aminoacyl-tRNA deacylase 1,1,0.999,4,10,10,10,6,4,6,4,6,4,846914560,202168720,
sp|F1QGH7|CTNB1_DANRE,F1QGH7,CTNB1_DANRE,ctnnb1,780,Danio rerio,1:Experimental evidence at protein level,Catenin beta-1,1,0.999,34,127,108,127,69,58,59,49,69,58,8787712000,6433452500,
sp|F1QGH9|PS11B_DANRE,F1QGH9,PS11B_DANRE,psmd11b,422,Danio rerio,2:Experimental evidence at transcript level,26S proteasome non-ATPase regulatory subunit 11B,1,0.999,31,63,63,163,32,31,32,31,79,84,4439316500,2790612740,
sp|F1QGW6|IF2G_DANRE,F1QGW6,IF2G_DANRE,eif2s3,472,Danio rerio,3:Protein inferred from homology,Eukaryotic translation initiation factor 2 subunit 3,1,0.999,37,134,134,134,67,67,67,67,67,67,13403087900,9078240300,
sp|F1QGZ6|MELK_DANRE,F1QGZ6,MELK_DANRE,melk,676,Danio rerio,2:Experimental evidence at transcript level,Maternal embryonic leucine zipper kinase,0.8578,0.9909,1,4,4,4,2,2,2,2,2,2,95794456,34646088,
sp|F1QH17|MCA3A_DANRE,F1QH17,MCA3A_DANRE,mical3a,1994,Danio rerio,2:Experimental evidence at transcript level,Protein-methionine sulfoxide oxidase mical3a,0.9995,0.9989,4,5,3,5,2,3,1,2,2,3,35426284,16854134,
sp|F1QJX5|UBR3_DANRE,F1QJX5,UBR3_DANRE,ubr3,1863,Danio rerio,2:Experimental evidence at transcript level,E3 ubiquitin-protein ligase ubr3,1,0.999,6,12,12,12,6,6,6,6,6,6,678793340,391681088,
sp|F1QLG5|ADN1A_DANRE,F1QLG5,ADN1A_DANRE,adnpa,969,Danio rerio,1:Experimental evidence at protein level,Activity-dependent neuroprotective protein a,0.9991,0.999,3,5,5,5,2,3,2,3,2,3,154625280,80970120,
sp|F1QLR3|FXR1_DANRE,F1QLR3,FXR1_DANRE,fxr1,622,Danio rerio,1:Experimental evidence at protein level,RNA-binding protein FXR1,1,0.999,10,22,22,22,12,10,12,10,12,10,977877760,647716100,
sp|F1QMB9|CCNK_DANRE,F1QMB9,CCNK_DANRE,ccnk,425,Danio rerio,2:Experimental evidence at transcript level,Cyclin-K,0.9244,0.9976,1,1,1,1,0,1,0,1,0,1,0,3368222,
sp|F1QMV3|TPC6B_DANRE,F1QMV3,TPC6B_DANRE,trappc6b,157,Danio rerio,2:Experimental evidence at transcript level,Trafficking protein particle complex subunit 6b,1,0.9985,11,11,11,11,10,1,10,1,10,1,456403616,27543290,
sp|F1QN54|KIF3B_DANRE,F1QN54,KIF3B_DANRE,kif3b,775,Danio rerio,2:Experimental evidence at transcript level,Kinesin-like protein KIF3B,0.9659,0.999,1,1,1,1,1,0,1,0,1,0,28471838,0,
sp|F1QNV4|NU133_DANRE,F1QNV4,NU133_DANRE,nup133,1136,Danio rerio,2:Experimental evidence at transcript level,Nuclear pore complex protein Nup133,1,0.9989,11,25,25,25,15,10,15,10,15,10,2270877950,589055360,
sp|F1QPC3|SARAF_DANRE,F1QPC3,SARAF_DANRE,saraf,345,Danio rerio,2:Experimental evidence at transcript level,Store-operated calcium entry-associated regulatory factor,0.993,0.992,2,5,5,5,2,3,2,3,2,3,174283136,173743120,
sp|F1QSQ0|DSC2L_DANRE,F1QSQ0,DSC2L_DANRE,dsc2l,934,Danio rerio,2:Experimental evidence at transcript level,Desmocollin 2-like protein,1,0.999,20,41,41,41,24,17,24,17,24,17,2505891580,1088386300,
sp|F1QUP1|RPZ_DANRE,F1QUP1,RPZ_DANRE,rpz,227,Danio rerio,1:Experimental evidence at protein level,Protein rapunzel,1,0.999,7,15,15,15,9,6,9,6,9,6,361443936,1009505090,
sp|F1QVU0|LTK_DANRE,F1QVU0,LTK_DANRE,ltk,1530,Danio rerio,1:Experimental evidence at protein level,Tyrosine-protein kinase receptor,0.9931,0.999,2,2,2,2,2,0,2,0,2,0,200082128,0,
sp|F1QWA8|SARM1_DANRE,F1QWA8,SARM1_DANRE,sarm1,713,Danio rerio,1:Experimental evidence at protein level,NAD(+) hydrolase SARM1,0.9766,0.9971,1,1,1,1,1,0,1,0,1,0,21879866,0,
sp|F1QWW8|KDSR_DANRE,F1QWW8,KDSR_DANRE,kdsr,332,Danio rerio,1:Experimental evidence at protein level,3-dehydrosphinganine reductase,0.9999,0.9987,3,4,4,4,1,3,1,3,1,3,73392856,200250720,
sp|F1QXM5|LDHD_DANRE,F1QXM5,LDHD_DANRE,ldhd,497,Danio rerio,2:Experimental evidence at transcript level,"Probable D-lactate dehydrogenase, mitochondrial",1,0.999,12,31,31,31,18,13,18,13,18,13,1543656580,907392130,
sp|F1QYJ6|ST6B1_DANRE,F1QYJ6,ST6B1_DANRE,sult6b1,296,Danio rerio,1:Experimental evidence at protein level,Sulfotransferase 6B1,1,0.999,8,32,32,32,18,14,18,14,18,14,2337754620,1856733060,
sp|F1QZ15|TPRKB_DANRE,F1QZ15,TPRKB_DANRE,tprkb,175,Danio rerio,2:Experimental evidence at transcript level,EKC/KEOPS complex subunit TPRKB,1,0.9988,4,7,7,7,4,3,4,3,4,3,296041248,150700768,
sp|F1R237|TDRD6_DANRE,F1R237,TDRD6_DANRE,tdrd6,2117,Danio rerio,1:Experimental evidence at protein level,Tudor domain-containing 6,0.5491,0.9609,1,13,13,13,9,4,9,4,9,4,4220251390,224294432,
sp|F1R2X6|PSM4B_DANRE,F1R2X6,PSM4B_DANRE,psme4b,1825,Danio rerio,3:Protein inferred from homology,Proteasome activator complex subunit 4B,1,0.999,10,11,10,11,7,4,7,3,7,4,710453380,211429600,
sp|F1R4C4|PIS4A_DANRE,F1R4C4,PIS4A_DANRE,pias4a,505,Danio rerio,2:Experimental evidence at transcript level,E3 SUMO-protein ligase PIAS4-A,0.9979,0.9966,4,4,4,4,3,1,3,1,3,1,118749296,0,
sp|F1R4U0|TXTPB_DANRE,F1R4U0,TXTPB_DANRE,slc25a1b,317,Danio rerio,3:Protein inferred from homology,"Tricarboxylate transport protein B, mitochondrial",1,0.9989,10,22,21,22,13,9,12,9,13,9,4074061820,4573248500,
sp|F1R520|CSTN1_DANRE,F1R520,CSTN1_DANRE,clstn1,954,Danio rerio,1:Experimental evidence at protein level,Calsyntenin-1,1,0.999,20,44,40,44,23,21,21,19,23,21,33755693100,1327550850,
sp|F1R5H6|BRD4_DANRE,F1R5H6,BRD4_DANRE,brd4,1444,Danio rerio,1:Experimental evidence at protein level,Bromodomain-containing protein 4,0.9963,0.9904,4,5,5,5,3,2,3,2,3,2,40164552,15766052,
sp|F1R6N4|ECHD1_DANRE,F1R6N4,ECHD1_DANRE,echdc1,302,Danio rerio,3:Protein inferred from homology,Ethylmalonyl-CoA decarboxylase,1,0.999,9,14,14,14,8,6,8,6,8,6,449482048,335673952,
sp|F1R777|MTA70_DANRE,F1R777,MTA70_DANRE,mettl3,584,Danio rerio,2:Experimental evidence at transcript level,N6-adenosine-methyltransferase subunit METTL3,1,0.999,11,20,20,20,13,7,13,7,13,7,585156930,286999648,
sp|F1RA39|MCA2B_DANRE,F1RA39,MCA2B_DANRE,mical2b,1679,Danio rerio,2:Experimental evidence at transcript level,[F-actin]-monooxygenase mical2b,0.6371,0.9836,2,1,1,3,0,1,0,1,1,2,0,29109202,
sp|F1RAX4|STRA6_DANRE,F1RAX4,STRA6_DANRE,stra6,670,Danio rerio,1:Experimental evidence at protein level,Receptor for retinol uptake stra6,1,0.999,4,6,6,6,4,2,4,2,4,2,139766704,96060728,
sp|F1RAX8|COQ6_DANRE,F1RAX8,COQ6_DANRE,coq6,484,Danio rerio,2:Experimental evidence at transcript level,"Ubiquinone biosynthesis monooxygenase COQ6, mitochondrial",0.9999,0.9968,3,4,4,4,1,3,1,3,1,3,494422816,939117380,
sp|F1RB95|RNF14_DANRE,F1RB95,RNF14_DANRE,rnf14,459,Danio rerio,2:Experimental evidence at transcript level,E3 ubiquitin-protein ligase RNF14,0.8614,0.9887,2,2,2,2,2,0,2,0,2,0,72024176,0,
sp|F1RBN2|SPAG1_DANRE,F1RBN2,SPAG1_DANRE,spag1a,427,Danio rerio,2:Experimental evidence at transcript level,Sperm-associated antigen 1A,1,0.9986,3,5,5,5,3,2,3,2,3,2,84478416,46430088,
sp|F1RCR6|TRIPC_DANRE,F1RCR6,TRIPC_DANRE,trip12,2026,Danio rerio,3:Protein inferred from homology,E3 ubiquitin-protein ligase TRIP12,1,0.999,17,29,29,29,18,11,18,11,18,11,795839230,502792512,
sp|F1RCY6|RENT1_DANRE,F1RCY6,RENT1_DANRE,upf1,1100,Danio rerio,2:Experimental evidence at transcript level,Regulator of nonsense transcripts 1,1,0.999,51,146,146,146,83,63,83,63,83,63,7234148400,4397212200,
sp|F1RD40|MYCB2_DANRE,F1RD40,MYCB2_DANRE,mycbp2,4574,Danio rerio,2:Experimental evidence at transcript level,E3 ubiquitin-protein ligase MYCBP2,1,0.9988,12,16,16,16,13,3,13,3,13,3,455149760,20984582,
sp|F1RDG9|FYNB_DANRE,F1RDG9,FYNB_DANRE,fynb,544,Danio rerio,2:Experimental evidence at transcript level,Tyrosine-protein kinase fynb,1,0.9989,15,14,8,36,7,7,3,5,19,17,500273152,698468100,
sp|F1RET2|SMYD5_DANRE,F1RET2,SMYD5_DANRE,smyd5,415,Danio rerio,2:Experimental evidence at transcript level,Histone-lysine N-trimethyltransferase SMYD5,1,0.999,12,27,27,27,15,12,15,12,15,12,852424450,493631552,
sp|F4ZGF2|COMTA_DANRE,F4ZGF2,COMTA_DANRE,comta,256,Danio rerio,1:Experimental evidence at protein level,Catechol O-methyltransferase A,1,0.999,10,22,18,22,13,9,11,7,13,9,1294852220,535991616,
sp|F6NSX9|Z687B_DANRE,F6NSX9,Z687B_DANRE,znf687b,1431,Danio rerio,2:Experimental evidence at transcript level,Zinc finger protein 687b,1,0.999,7,10,9,10,6,4,5,4,6,4,331061984,115369224,
sp|F6NVH9|NIPS1_DANRE,F6NVH9,NIPS1_DANRE,nipsnap1,279,Danio rerio,3:Protein inferred from homology,Protein NipSnap homolog 1,1,0.999,4,6,6,6,3,3,3,3,3,3,112904112,171668000,
sp|F6NXI9|TRNT1_DANRE,F6NXI9,TRNT1_DANRE,trnt1,431,Danio rerio,2:Experimental evidence at transcript level,"CCA tRNA nucleotidyltransferase 1, mitochondrial",1,0.999,8,12,12,12,10,2,10,2,10,2,652350270,96437264,
sp|F6P3G4|PS11A_DANRE,F6P3G4,PS11A_DANRE,psmd11a,421,Danio rerio,2:Experimental evidence at transcript level,26S proteasome non-ATPase regulatory subunit 11A,1,0.999,31,197,97,197,98,99,51,46,98,99,15262799900,11304133600,
sp|F8W2M1|HACE1_DANRE,F8W2M1,HACE1_DANRE,hace1,904,Danio rerio,3:Protein inferred from homology,E3 ubiquitin-protein ligase HACE1,0.769,0.9913,1,1,1,1,1,0,1,0,1,0,2963658.8,0,
sp|F8W2M8|TPP1_DANRE,F8W2M8,TPP1_DANRE,tpp1,557,Danio rerio,1:Experimental evidence at protein level,Tripeptidyl-peptidase 1,1,0.999,11,66,66,66,37,29,37,29,37,29,5847364600,4572694500,
sp|F8W3X3|PCD19_DANRE,F8W3X3,PCD19_DANRE,pcdh19,1088,Danio rerio,1:Experimental evidence at protein level,Protocadherin-19,1,0.999,11,18,18,18,10,8,10,8,10,8,486747616,1731656450,
sp|F8W463|P2X4A_DANRE,F8W463,P2X4A_DANRE,p2rx4a,389,Danio rerio,1:Experimental evidence at protein level,P2X purinoceptor 4a,0.9522,0.9985,1,1,1,1,1,0,1,0,1,0,19612488,0,
sp|F8WK50|FLII_DANRE,F8WK50,FLII_DANRE,flii,1259,Danio rerio,1:Experimental evidence at protein level,Protein flightless-1 homolog,1,0.999,10,16,16,16,11,5,11,5,11,5,335598400,129856120,
sp|H2EQR6|DSG21_DANRE,H2EQR6,DSG21_DANRE,dsg2.1,1142,Danio rerio,2:Experimental evidence at transcript level,Desmoglein-2.1,1,0.999,16,39,39,39,24,15,24,15,24,15,1630650110,938115140,
sp|L7VG99|T132E_DANRE,L7VG99,T132E_DANRE,tmem132e,1073,Danio rerio,2:Experimental evidence at transcript level,Transmembrane protein 132E,1,0.9926,7,8,8,8,7,1,7,1,7,1,169476144,20846888,
sp|O13146|EPHA3_DANRE,O13146,EPHA3_DANRE,epha3,981,Danio rerio,1:Experimental evidence at protein level,Ephrin type-A receptor 3,0.9667,0.992,3,3,3,4,3,0,3,0,3,1,2812212990,0,
sp|O13147|EPHB3_DANRE,O13147,EPHB3_DANRE,ephb3,500,Danio rerio,2:Experimental evidence at transcript level,Ephrin type-B receptor 3 (Fragment),0.9995,0.999,4,6,6,7,3,3,3,3,3,4,136747520,99649136,
sp|O13168|TLE3B_DANRE,O13168,TLE3B_DANRE,tle3b,771,Danio rerio,1:Experimental evidence at protein level,Transducin-like enhancer protein 3-B,1,0.999,22,97,11,97,50,47,5,6,50,47,10727461900,7355346400,
sp|O42182|FBLN1_DANRE,O42182,FBLN1_DANRE,fbln1,681,Danio rerio,2:Experimental evidence at transcript level,Fibulin-1,1,0.999,22,83,83,83,44,39,44,39,44,39,6719137300,4054164480,
sp|O42248|GBLP_DANRE,O42248,GBLP_DANRE,gnb2l1,317,Danio rerio,1:Experimental evidence at protein level,Small ribosomal subunit protein RACK1,1,0.999,29,376,376,376,189,187,189,187,189,187,81661854000,57177919000,
sp|O42363|APOA1_DANRE,O42363,APOA1_DANRE,apoa1a,262,Danio rerio,1:Experimental evidence at protein level,Apolipoprotein A-Ia,1,0.999,33,910,910,910,441,469,441,469,441,469,312445534000,290984919000,
sp|O42364|APOEB_DANRE,O42364,APOEB_DANRE,apoeb,281,Danio rerio,2:Experimental evidence at transcript level,Apolipoprotein Eb,1,0.999,19,182,182,182,100,82,100,82,100,82,48144056000,23620403200,
sp|O42376|MK12_DANRE,O42376,MK12_DANRE,mapk12,363,Danio rerio,2:Experimental evidence at transcript level,Mitogen-activated protein kinase 12,1,0.999,9,18,18,27,12,6,12,6,16,11,480514432,236102848,
sp|O57474|CXA1_DANRE,O57474,CXA1_DANRE,gja1,381,Danio rerio,1:Experimental evidence at protein level,Gap junction alpha-1 protein,0.9959,0.999,2,5,5,5,3,2,3,2,3,2,179256288,144030656,
sp|O57521|HS90B_DANRE,O57521,HS90B_DANRE,hsp90ab1,725,Danio rerio,1:Experimental evidence at protein level,Heat shock protein HSP 90-beta,1,0.999,60,698,479,698,357,341,248,231,357,341,142323352000,111285125000,
sp|O73715|LDB1A_DANRE,O73715,LDB1A_DANRE,ldb1a,374,Danio rerio,2:Experimental evidence at transcript level,LIM domain-binding protein 1-A,1,0.999,6,12,12,12,6,6,6,6,6,6,334780896,198787984,
sp|O73872|SODC_DANRE,O73872,SODC_DANRE,sod1,154,Danio rerio,2:Experimental evidence at transcript level,Superoxide dismutase [Cu-Zn],1,0.999,17,277,277,277,146,131,146,131,146,131,79146992000,63924752000,
sp|O73874|EFNB2_DANRE,O73874,EFNB2_DANRE,efnb2a,332,Danio rerio,1:Experimental evidence at protein level,Ephrin-B2a,1,0.999,6,12,12,12,7,5,7,5,7,5,552185340,299873152,
sp|O73875|EPB4A_DANRE,O73875,EPB4A_DANRE,ephb4a,987,Danio rerio,1:Experimental evidence at protein level,Ephrin type-B receptor 4a,1,0.9989,6,11,5,11,6,5,3,2,6,5,386178496,287806112,
sp|O93409|MLRSA_DANRE,O93409,MLRSA_DANRE,mylpfa,169,Danio rerio,1:Experimental evidence at protein level,"Myosin regulatory light chain 2, skeletal muscle isoform A",1,0.999,25,1623,597,1623,832,791,315,282,832,791,780490380000,676400990000,
sp|O93430|GLRA1_DANRE,O93430,GLRA1_DANRE,glra1,444,Danio rerio,1:Experimental evidence at protein level,Glycine receptor subunit alphaZ1,0.9823,0.9945,2,3,3,3,2,1,2,1,2,1,6894360.5,1723254.4,
sp|P0C8M4|MTURN_DANRE,P0C8M4,MTURN_DANRE,mturn,133,Danio rerio,2:Experimental evidence at transcript level,Maturin,0.9974,0.9872,2,9,9,9,4,5,4,5,4,5,676642370,452303456,
sp|P0C8Y3|BBLN_DANRE,P0C8Y3,BBLN_DANRE,bbln,99,Danio rerio,3:Protein inferred from homology,Bublin coiled-coil protein,0.7785,0.9917,1,2,2,2,1,1,1,1,1,1,20446364,23877654,
sp|P0CH95|PHF8_DANRE,P0CH95,PHF8_DANRE,phf8,1032,Danio rerio,1:Experimental evidence at protein level,Histone lysine demethylase PHF8,1,0.9985,6,8,8,8,6,2,6,2,6,2,164047520,67572016,
sp|P13104|TPM1_DANRE,P13104,TPM1_DANRE,tpma,284,Danio rerio,2:Experimental evidence at transcript level,Tropomyosin alpha-1 chain,1,0.999,48,1094,1094,1094,543,551,543,551,543,551,589812990000,434999296000,
sp|P17561|EPD_DANRE,P17561,EPD_DANRE,epd,217,Danio rerio,2:Experimental evidence at transcript level,Ependymin,1,0.999,8,55,55,55,30,25,30,25,30,25,10883418100,9638147100,
sp|P35359|OPSD_DANRE,P35359,OPSD_DANRE,rho,354,Danio rerio,1:Experimental evidence at protein level,Rhodopsin,1,0.999,5,13,13,13,7,6,7,6,7,6,727258750,514791680,
sp|P50392|PA24A_DANRE,P50392,PA24A_DANRE,pla2g4a,741,Danio rerio,2:Experimental evidence at transcript level,Cytosolic phospholipase A2,0.9987,0.9948,4,5,5,5,3,2,3,2,3,2,193566928,61118428,
sp|P53405|ISL1_DANRE,P53405,ISL1_DANRE,isl1,349,Danio rerio,2:Experimental evidence at transcript level,Insulin gene enhancer protein isl-1,0.972,0.9984,2,3,2,3,2,1,1,1,2,1,119073920,55090152,
sp|P56224|P3F3A_DANRE,P56224,P3F3A_DANRE,pou3f3a,438,Danio rerio,2:Experimental evidence at transcript level,"POU domain, class 3, transcription factor 3-A",0.9335,0.9969,2,4,0,4,2,2,0,0,2,2,218252128,149733232,"sp|P79745|P3F3B_DANRE, sp|P79746|PO3F2_DANRE"
sp|P58239|CNMD_DANRE,P58239,CNMD_DANRE,cnmd,286,Danio rerio,2:Experimental evidence at transcript level,Leukocyte cell-derived chemotaxin 1,1,0.999,4,8,8,8,4,4,4,4,4,4,373323424,317007808,
sp|P58781|ADA2_DANRE,P58781,ADA2_DANRE,ada2a,503,Danio rerio,2:Experimental evidence at transcript level,Adenosine deaminase 2-A,1,0.999,20,55,55,55,25,30,25,30,25,30,2277905410,1800631550,
sp|P59015|VPS18_DANRE,P59015,VPS18_DANRE,vps18,974,Danio rerio,2:Experimental evidence at transcript level,Vacuolar protein sorting-associated protein 18 homolog,1,0.9979,6,7,7,7,5,2,5,2,5,2,165750592,79273128,
sp|P59723|HIF1N_DANRE,P59723,HIF1N_DANRE,hif1an,344,Danio rerio,2:Experimental evidence at transcript level,Hypoxia-inducible factor 1-alpha inhibitor,0.9997,0.999,5,6,6,6,5,1,5,1,5,1,204108720,47763084,
sp|P61485|RL36A_DANRE,P61485,RL36A_DANRE,rpl36a,106,Danio rerio,1:Experimental evidence at protein level,Large ribosomal subunit protein eL42,1,0.999,6,19,19,19,9,10,9,10,9,10,1789617280,1382466180,
sp|P62084|RS7_DANRE,P62084,RS7_DANRE,rps7,194,Danio rerio,1:Experimental evidence at protein level,Small ribosomal subunit protein eS7,1,0.999,14,54,54,54,26,28,26,28,26,28,2356392700,4454028300,
sp|P62247|RS8_DANRE,P62247,RS8_DANRE,rps8,208,Danio rerio,1:Experimental evidence at protein level,Small ribosomal subunit protein eS8,1,0.999,17,54,54,54,21,33,21,33,21,33,1984434560,6275287600,
sp|P62447|ZFPL1_DANRE,P62447,ZFPL1_DANRE,zfpl1,317,Danio rerio,2:Experimental evidence at transcript level,Zinc finger protein-like 1,1,0.999,4,6,6,6,5,1,5,1,5,1,218954016,114896656,
sp|P79728|EFNA5_DANRE,P79728,EFNA5_DANRE,efna5b,228,Danio rerio,1:Experimental evidence at protein level,Ephrin-A5b,0.5984,0.9807,1,3,3,3,1,2,1,2,1,2,24446180,18963458,
sp|P79732|RIR1_DANRE,P79732,RIR1_DANRE,rrm1,794,Danio rerio,2:Experimental evidence at transcript level,Ribonucleoside-diphosphate reductase large subunit,1,0.999,25,107,107,107,56,51,56,51,56,51,7308814300,3604528380,
sp|P79733|RIR2_DANRE,P79733,RIR2_DANRE,rrm2,386,Danio rerio,1:Experimental evidence at protein level,Ribonucleoside-diphosphate reductase subunit M2,1,0.9989,6,14,14,14,8,6,8,6,8,6,504566336,285610656,
sp|P79735|RAN_DANRE,P79735,RAN_DANRE,ran,215,Danio rerio,2:Experimental evidence at transcript level,GTP-binding nuclear protein Ran,1,0.999,29,412,412,412,213,199,213,199,213,199,108298674000,69671297000,
sp|P79737|RASN_DANRE,P79737,RASN_DANRE,nras,188,Danio rerio,2:Experimental evidence at transcript level,GTPase NRas,1,0.999,9,11,11,28,6,5,6,5,16,12,601124420,429903680,
sp|P79741|PESC_DANRE,P79741,PESC_DANRE,pes,583,Danio rerio,2:Experimental evidence at transcript level,Pescadillo,0.9736,0.9974,1,1,1,1,1,0,1,0,1,0,7410142,0,
sp|P83571|RUVB2_DANRE,P83571,RUVB2_DANRE,ruvbl2,463,Danio rerio,1:Experimental evidence at protein level,RuvB-like 2,1,0.999,24,68,68,68,34,34,34,34,34,34,4042615040,3348837120,
sp|P86347|BORE2_DANRE,P86347,BORE2_DANRE,cdca9,255,Danio rerio,2:Experimental evidence at transcript level,Borealin-2,0.4639,0.9672,1,2,2,2,0,2,0,2,0,2,0,82762680,
sp|P86839|NEST_DANRE,P86839,NEST_DANRE,nes,1265,Danio rerio,2:Experimental evidence at transcript level,Nestin,0.9574,0.9958,1,2,2,2,1,1,1,1,1,1,25088192,29047490,
sp|Q05AK9|TMA7_DANRE,Q05AK9,TMA7_DANRE,tma7,64,Danio rerio,3:Protein inferred from homology,Translation machinery-associated protein 7,0.9999,0.9964,3,5,5,5,3,2,3,2,3,2,272817184,158924544,
sp|Q05AL1|ARMC8_DANRE,Q05AL1,ARMC8_DANRE,armc8,673,Danio rerio,2:Experimental evidence at transcript level,Armadillo repeat-containing protein 8,0.9999,0.9985,3,5,5,5,3,2,3,2,3,2,67198040,24688418,
sp|Q05AL2|PPM1H_DANRE,Q05AL2,PPM1H_DANRE,ppm1h,516,Danio rerio,2:Experimental evidence at transcript level,Protein phosphatase 1H,0.9994,0.9979,3,5,5,5,4,1,4,1,4,1,136010416,84680848,
sp|Q05AM4|FAH2B_DANRE,Q05AM4,FAH2B_DANRE,faah2b,526,Danio rerio,2:Experimental evidence at transcript level,Fatty-acid amide hydrolase 2-B,1,0.9989,5,8,8,12,5,3,5,3,7,5,245090624,55177824,
sp|Q05AM5|ELP2_DANRE,Q05AM5,ELP2_DANRE,elp2,821,Danio rerio,2:Experimental evidence at transcript level,Elongator complex protein 2,1,0.999,3,5,5,5,3,2,3,2,3,2,123030320,63383616,
sp|Q06725|N2F1A_DANRE,Q06725,N2F1A_DANRE,nr2f1a,411,Danio rerio,2:Experimental evidence at transcript level,Nuclear receptor subfamily 2 group F member 1-A,1,0.9989,5,10,4,10,6,4,3,1,6,4,305218240,153509392,
sp|Q06S87|HIUH_DANRE,Q06S87,HIUH_DANRE,urah,138,Danio rerio,1:Experimental evidence at protein level,5-hydroxyisourate hydrolase,1,0.9981,3,13,13,13,8,5,8,5,8,5,702025470,325584128,
sp|Q08BB1|EFGM_DANRE,Q08BB1,EFGM_DANRE,gfm1,745,Danio rerio,2:Experimental evidence at transcript level,"Elongation factor G, mitochondrial",1,0.999,18,38,38,38,21,17,21,17,21,17,1010068670,741455420,
sp|Q08BB2|P2012_DANRE,Q08BB2,P2012_DANRE,pm20d1.2,522,Danio rerio,2:Experimental evidence at transcript level,N-fatty-acyl-amino acid synthase/hydrolase PM20D1.2,0.9783,0.999,2,3,3,3,3,0,3,0,3,0,36854812,0,
sp|Q08BB5|CTL2A_DANRE,Q08BB5,CTL2A_DANRE,ctdspl2a,469,Danio rerio,2:Experimental evidence at transcript level,CTD small phosphatase-like protein 2-A,1,0.999,5,7,1,7,5,2,1,0,5,2,343087360,80314192,
sp|Q08BH5|RBM46_DANRE,Q08BH5,RBM46_DANRE,rbm46,510,Danio rerio,2:Experimental evidence at transcript level,Probable RNA-binding protein 46,0.962,0.9988,1,2,2,2,1,1,1,1,1,1,28601584,23675344,
sp|Q08BI9|MCU_DANRE,Q08BI9,MCU_DANRE,mcu,376,Danio rerio,1:Experimental evidence at protein level,"Calcium uniporter protein, mitochondrial",1,0.999,7,17,17,17,8,9,8,9,8,9,749013570,490385664,
sp|Q08BJ2|KHDR2_DANRE,Q08BJ2,KHDR2_DANRE,khdrbs2,346,Danio rerio,2:Experimental evidence at transcript level,"KH domain-containing, RNA-binding, signal transduction-associated protein 2",1,0.999,10,24,24,24,14,10,14,10,14,10,9004629000,868907970,
sp|Q08BL7|GLCTK_DANRE,Q08BL7,GLCTK_DANRE,glyctk,502,Danio rerio,2:Experimental evidence at transcript level,Glycerate kinase,1,0.999,11,19,19,19,12,7,12,7,12,7,252806352,314112320,
sp|Q08BV2|TYW5_DANRE,Q08BV2,TYW5_DANRE,tyw5,326,Danio rerio,2:Experimental evidence at transcript level,tRNA wybutosine-synthesizing protein 5,0.999,0.9988,3,4,4,4,3,1,3,1,3,1,314906656,41251296,
sp|Q08BY0|NDUF7_DANRE,Q08BY0,NDUF7_DANRE,ndufaf7,422,Danio rerio,2:Experimental evidence at transcript level,"Protein arginine methyltransferase NDUFAF7, mitochondrial",1,0.999,4,8,8,8,4,4,4,4,4,4,59621240,15460962,
sp|Q08BY1|MED17_DANRE,Q08BY1,MED17_DANRE,med17,643,Danio rerio,2:Experimental evidence at transcript level,Mediator of RNA polymerase II transcription subunit 17,0.9989,0.9983,2,3,3,3,2,1,2,1,2,1,43232136,6067496.5,
sp|Q08C33|ISOC1_DANRE,Q08C33,ISOC1_DANRE,isoc1,283,Danio rerio,2:Experimental evidence at transcript level,Isochorismatase domain-containing protein 1,1,0.999,9,62,62,62,31,31,31,31,31,31,6969377800,4646400000,
sp|Q08C57|FDX2_DANRE,Q08C57,FDX2_DANRE,fdx2,195,Danio rerio,2:Experimental evidence at transcript level,"Ferredoxin-2, mitochondrial",0.9999,0.9988,2,3,3,3,1,2,1,2,1,2,172209088,159675056,
sp|Q08C76|SSUH2_DANRE,Q08C76,SSUH2_DANRE,ssuh2,361,Danio rerio,2:Experimental evidence at transcript level,Protein SSUH2 homolog,1,0.999,15,114,114,114,63,51,63,51,63,51,10607263700,7532625400,
sp|Q08C92|TYW1_DANRE,Q08C92,TYW1_DANRE,tyw1,730,Danio rerio,2:Experimental evidence at transcript level,S-adenosyl-L-methionine-dependent tRNA 4-demethylwyosine synthase TYW1,1,0.9963,4,7,7,7,4,3,4,3,4,3,136490752,396965504,
sp|Q08C93|ABD12_DANRE,Q08C93,ABD12_DANRE,abhd12,382,Danio rerio,2:Experimental evidence at transcript level,Lysophosphatidylserine lipase ABHD12,0.9259,0.9977,2,2,2,2,2,0,2,0,2,0,32671514,0,
sp|Q08CH3|MPND_DANRE,Q08CH3,MPND_DANRE,mpnd,458,Danio rerio,2:Experimental evidence at transcript level,MPN domain-containing protein,1,0.999,7,11,11,11,6,5,6,5,6,5,318870816,254372144,
sp|Q08CH8|ZTRF1_DANRE,Q08CH8,ZTRF1_DANRE,zftraf1,382,Danio rerio,2:Experimental evidence at transcript level,Zinc finger TRAF-type-containing protein 1,1,0.999,7,10,10,10,7,3,7,3,7,3,248586784,124774104,
sp|Q08CK1|ECSIT_DANRE,Q08CK1,ECSIT_DANRE,ecsit,452,Danio rerio,2:Experimental evidence at transcript level,"Evolutionarily conserved signaling intermediate in Toll pathway, mitochondrial",0.8681,0.9956,2,2,2,2,1,1,1,1,1,1,3678334,439489152,
sp|Q08CK7|IF2B1_DANRE,Q08CK7,IF2B1_DANRE,igf2bp1,598,Danio rerio,1:Experimental evidence at protein level,Insulin-like growth factor 2 mRNA-binding protein 1,1,0.999,41,213,173,213,107,106,88,85,107,106,23177906200,18290802700,
sp|Q08CL8|CNO10_DANRE,Q08CL8,CNO10_DANRE,cnot10,624,Danio rerio,2:Experimental evidence at transcript level,CCR4-NOT transcription complex subunit 10,0.9996,0.999,3,5,5,5,2,3,2,3,2,3,18189364,51004432,
sp|Q08CN0|TPPC2_DANRE,Q08CN0,TPPC2_DANRE,trappc2,140,Danio rerio,2:Experimental evidence at transcript level,Trafficking protein particle complex subunit 2,0.9988,0.999,2,3,3,3,2,1,2,1,2,1,121721080,32748604,
sp|Q08CS6|MOXD2_DANRE,Q08CS6,MOXD2_DANRE,moxd2,572,Danio rerio,2:Experimental evidence at transcript level,DBH-like monooxygenase protein 2 homolog,0.4094,0.9594,1,1,1,1,1,0,1,0,1,0,0,0,
sp|Q0D285|TM141_DANRE,Q0D285,TM141_DANRE,tmem141,124,Danio rerio,2:Experimental evidence at transcript level,Transmembrane protein 141,0.3825,0.9548,1,1,1,1,1,0,1,0,1,0,533946400,0,
sp|Q0E671|NEUAA_DANRE,Q0E671,NEUAA_DANRE,cmasa,430,Danio rerio,1:Experimental evidence at protein level,N-acylneuraminate cytidylyltransferase A,1,0.999,12,29,29,29,19,10,19,10,19,10,1226770180,792851840,
sp|Q0IIP8|CRP_DANRE,Q0IIP8,CRP_DANRE,crp,225,Danio rerio,1:Experimental evidence at protein level,C-reactive protein,1,0.999,9,60,60,60,30,30,30,30,30,30,7207496700,4813016100,
sp|Q0P3W2|OLF3B_DANRE,Q0P3W2,OLF3B_DANRE,olfml3b,394,Danio rerio,2:Experimental evidence at transcript level,Olfactomedin-like protein 3B,0.9999,0.9986,3,5,5,5,3,2,3,2,3,2,125471752,44505396,
sp|Q0P3X8|LTOR4_DANRE,Q0P3X8,LTOR4_DANRE,lamtor4,99,Danio rerio,3:Protein inferred from homology,Ragulator complex protein LAMTOR4,1,0.9964,3,7,7,7,5,2,5,2,5,2,422717120,238942624,
sp|Q0P3Z2|PTER_DANRE,Q0P3Z2,PTER_DANRE,pter,349,Danio rerio,2:Experimental evidence at transcript level,Phosphotriesterase-related protein,1,0.999,20,91,91,91,50,41,50,41,50,41,8500312600,5862888400,
sp|Q0P424|ELP6_DANRE,Q0P424,ELP6_DANRE,elp6,264,Danio rerio,2:Experimental evidence at transcript level,Elongator complex protein 6,0.9999,0.9969,3,6,6,6,3,3,3,3,3,3,196776416,149495632,
sp|Q0P436|TM14C_DANRE,Q0P436,TM14C_DANRE,tmem14c,107,Danio rerio,3:Protein inferred from homology,Transmembrane protein 14C,0.9994,0.9989,2,4,4,4,3,1,3,1,3,1,50091876,25888550,
sp|Q0P442|RNKB_DANRE,Q0P442,RNKB_DANRE,rnasekb,101,Danio rerio,3:Protein inferred from homology,Ribonuclease kappa-B,0.7877,0.9922,1,2,2,2,1,1,1,1,1,1,74636912,73322272,
sp|Q0P448|DPCD_DANRE,Q0P448,DPCD_DANRE,dpcd,200,Danio rerio,2:Experimental evidence at transcript level,Protein DPCD,0.5566,0.9772,1,1,1,1,1,0,1,0,1,0,69847088,0,
sp|Q0P451|COA5_DANRE,Q0P451,COA5_DANRE,coa5,75,Danio rerio,3:Protein inferred from homology,Cytochrome c oxidase assembly factor 5,1,0.9986,4,8,8,8,4,4,4,4,4,4,449585216,317380896,
sp|Q0P487|NB5R2_DANRE,Q0P487,NB5R2_DANRE,cyb5r2,309,Danio rerio,2:Experimental evidence at transcript level,NADH-cytochrome b5 reductase 2,1,0.999,12,29,29,29,18,11,18,11,18,11,1433147260,697132990,
sp|Q0P499|SYEM_DANRE,Q0P499,SYEM_DANRE,ears2,503,Danio rerio,2:Experimental evidence at transcript level,"Nondiscriminating glutamyl-tRNA synthetase EARS2, mitochondrial",0.8838,0.9962,1,1,1,1,1,0,1,0,1,0,6327587,0,
sp|Q0P4A4|NAT14_DANRE,Q0P4A4,NAT14_DANRE,nat14,280,Danio rerio,2:Experimental evidence at transcript level,Probable N-acetyltransferase 14,0.7287,0.9892,1,1,1,1,1,0,1,0,1,0,32623082,0,
sp|Q0P4F7|ACSF2_DANRE,Q0P4F7,ACSF2_DANRE,acsf2,606,Danio rerio,2:Experimental evidence at transcript level,"Medium-chain acyl-CoA ligase ACSF2, mitochondrial",1,0.999,22,86,86,86,47,39,47,39,47,39,5279626200,4345445900,
sp|Q0V947|T161A_DANRE,Q0V947,T161A_DANRE,tmem161a,495,Danio rerio,2:Experimental evidence at transcript level,Transmembrane protein 161A,0.949,0.9984,1,1,1,1,1,0,1,0,1,0,842238.44,0,
sp|Q0VA82|MFSD8_DANRE,Q0VA82,MFSD8_DANRE,mfsd8,504,Danio rerio,2:Experimental evidence at transcript level,Major facilitator superfamily domain-containing protein 8,0.5616,0.9776,1,2,2,2,1,1,1,1,1,1,158620640,113315120,
sp|Q0VFV6|SELS_DANRE,Q0VFV6,SELS_DANRE,vimp,190,Danio rerio,2:Experimental evidence at transcript level,Selenoprotein S,0.9915,0.9971,2,4,4,4,2,2,2,2,2,2,36425760,32148106,
sp|Q0VIL3|OTOMP_DANRE,Q0VIL3,OTOMP_DANRE,otomp,371,Danio rerio,2:Experimental evidence at transcript level,Otolith matrix protein 1,1,0.999,18,61,61,61,33,28,33,28,33,28,2989382140,1721886980,
sp|Q155U0|VPS51_DANRE,Q155U0,VPS51_DANRE,vps51,827,Danio rerio,2:Experimental evidence at transcript level,Vacuolar protein sorting-associated protein 51 homolog,1,0.9988,5,6,6,6,3,3,3,3,3,3,1926641150,4751692300,
sp|Q1AMT3|FAB1A_DANRE,Q1AMT3,FAB1A_DANRE,fabp1a,127,Danio rerio,2:Experimental evidence at transcript level,"Fatty acid binding protein 1-A, liver",0.9537,0.9986,1,2,2,2,1,1,1,1,1,1,49005344,116384264,
sp|Q1ECZ4|CASC3_DANRE,Q1ECZ4,CASC3_DANRE,casc3,754,Danio rerio,1:Experimental evidence at protein level,Protein CASC3,0.9997,0.9973,3,4,4,4,3,1,3,1,3,1,86392064,39776988,
sp|Q1ED21|NR2CA_DANRE,Q1ED21,NR2CA_DANRE,nr2c2ap,141,Danio rerio,2:Experimental evidence at transcript level,Nuclear receptor 2C2-associated protein,1,0.999,6,8,8,8,5,3,5,3,5,3,236758816,144602912,
sp|Q1JPX3|SYFA_DANRE,Q1JPX3,SYFA_DANRE,farsa,497,Danio rerio,2:Experimental evidence at transcript level,Phenylalanine--tRNA ligase alpha subunit,1,0.999,20,69,69,69,40,29,40,29,40,29,2703368700,1584221820,
sp|Q1JPY4|TBPL2_DANRE,Q1JPY4,TBPL2_DANRE,tbpl2,312,Danio rerio,1:Experimental evidence at protein level,TATA box-binding protein-like 2,1,0.9988,2,4,0,4,3,1,0,0,3,1,105417040,16769709,sp|Q7SXL3|TBP_DANRE
sp|Q1JPY5|CYP51_DANRE,Q1JPY5,CYP51_DANRE,cyp51,499,Danio rerio,1:Experimental evidence at protein level,Lanosterol 14-alpha demethylase,0.872,0.9957,1,1,1,1,1,0,1,0,1,0,30501188,0,
sp|Q1JPY8|PSPC1_DANRE,Q1JPY8,PSPC1_DANRE,pspc1,512,Danio rerio,2:Experimental evidence at transcript level,Paraspeckle component 1,1,0.999,14,38,38,38,22,16,22,16,22,16,4629442600,4078476800,
sp|Q1JPZ3|SRC_DANRE,Q1JPZ3,SRC_DANRE,src,534,Danio rerio,1:Experimental evidence at protein level,Proto-oncogene tyrosine-protein kinase Src,1,0.999,12,11,11,25,7,4,7,4,14,11,466536096,316044800,
sp|Q1JPZ7|PRP39_DANRE,Q1JPZ7,PRP39_DANRE,prpf39,752,Danio rerio,2:Experimental evidence at transcript level,Pre-mRNA-processing factor 39,1,0.999,26,91,91,91,48,43,48,43,48,43,4263150850,3254605820,
sp|Q1L673|VDRB_DANRE,Q1L673,VDRB_DANRE,vdrb,422,Danio rerio,2:Experimental evidence at transcript level,Vitamin D3 receptor B,1,0.999,4,5,1,5,4,1,1,0,4,1,114656400,29051674,
sp|Q1L8D2|MANEL_DANRE,Q1L8D2,MANEL_DANRE,maneal,442,Danio rerio,3:Protein inferred from homology,"Glycoprotein endo-alpha-1,2-mannosidase-like protein",0.9228,0.9964,2,2,2,2,1,1,1,1,1,1,18591148,33715612,
sp|Q1L8F4|T178B_DANRE,Q1L8F4,T178B_DANRE,tmem178b,294,Danio rerio,2:Experimental evidence at transcript level,Transmembrane protein 178B,0.9539,0.9986,1,1,1,1,1,0,1,0,1,0,38252044,0,
sp|Q1L8G7|GATD1_DANRE,Q1L8G7,GATD1_DANRE,gatad1,242,Danio rerio,2:Experimental evidence at transcript level,GATA zinc finger domain-containing protein 1,0.967,0.999,1,1,1,1,1,0,1,0,1,0,21273314,0,
sp|Q1L8L9|KAD2_DANRE,Q1L8L9,KAD2_DANRE,ak2,241,Danio rerio,2:Experimental evidence at transcript level,"Adenylate kinase 2, mitochondrial",1,0.999,21,178,178,178,97,81,97,81,97,81,13373128700,10171641900,
sp|Q1L8P7|TSP3B_DANRE,Q1L8P7,TSP3B_DANRE,thbs3b,929,Danio rerio,3:Protein inferred from homology,Thrombospondin-3b,1,0.999,7,11,11,13,5,6,5,6,6,7,267205120,178498208,
sp|Q1L8U8|STB1A_DANRE,Q1L8U8,STB1A_DANRE,setdb1a,1436,Danio rerio,3:Protein inferred from homology,Histone-lysine N-methyltransferase SETDB1-A,0.9938,0.9986,3,3,3,3,1,2,1,2,1,2,12980588,187037056,
sp|Q1L987|ATPF1_DANRE,Q1L987,ATPF1_DANRE,atpaf1,302,Danio rerio,2:Experimental evidence at transcript level,ATP synthase mitochondrial F1 complex assembly factor 1,1,0.999,4,7,7,7,5,2,5,2,5,2,346183808,87712144,
sp|Q1L994|PPR37_DANRE,Q1L994,PPR37_DANRE,ppp1r37,919,Danio rerio,2:Experimental evidence at transcript level,Protein phosphatase 1 regulatory subunit 37,0.9936,0.999,1,3,3,3,1,2,1,2,1,2,170034656,48225304,
sp|Q1LU93|ABITM_DANRE,Q1LU93,ABITM_DANRE,abitram,177,Danio rerio,2:Experimental evidence at transcript level,Protein Abitram,0.9893,0.999,2,3,3,3,2,1,2,1,2,1,45729892,37120848,
sp|Q1LU99|RIPR2_DANRE,Q1LU99,RIPR2_DANRE,ripor2,1083,Danio rerio,2:Experimental evidence at transcript level,Rho family-interacting cell polarization regulator 2,0.441,0.9641,2,4,4,4,2,2,2,2,2,2,140493920,33178560,
sp|Q1LUA6|TRIO_DANRE,Q1LUA6,TRIO_DANRE,trio,3028,Danio rerio,3:Protein inferred from homology,Triple functional domain protein,1,0.999,11,12,12,12,11,1,11,1,11,1,197849936,9388589,
sp|Q1LUC1|5MP1_DANRE,Q1LUC1,5MP1_DANRE,bzw2,421,Danio rerio,2:Experimental evidence at transcript level,eIF5-mimic protein 1,1,0.999,8,5,5,22,3,2,3,2,11,11,136638528,153837504,
sp|Q1LUC3|KAT2B_DANRE,Q1LUC3,KAT2B_DANRE,kat2b,796,Danio rerio,2:Experimental evidence at transcript level,Histone acetyltransferase KAT2B,0.9895,0.9929,3,4,3,4,3,1,2,1,3,1,117458880,61299284,
sp|Q1LUI2|HDDC2_DANRE,Q1LUI2,HDDC2_DANRE,hddc2,200,Danio rerio,2:Experimental evidence at transcript level,5'-deoxynucleotidase HDDC2,1,0.999,8,24,24,24,14,10,14,10,14,10,680350340,395085472,
sp|Q1LUK1|MIC13_DANRE,Q1LUK1,MIC13_DANRE,micos13,111,Danio rerio,3:Protein inferred from homology,MICOS complex subunit MIC13,1,0.9986,3,5,5,5,4,1,4,1,4,1,232027456,2384637.2,
sp|Q1LUM3|ENDUC_DANRE,Q1LUM3,ENDUC_DANRE,endouc,309,Danio rerio,2:Experimental evidence at transcript level,Uridylate-specific endoribonuclease C,1,0.9936,7,7,7,7,5,2,5,2,5,2,115003984,65070276,
sp|Q1LUS8|RBP10_DANRE,Q1LUS8,RBP10_DANRE,ranbp10,604,Danio rerio,3:Protein inferred from homology,Ran-binding protein 10,0.9669,0.999,1,1,1,1,1,0,1,0,1,0,17795194,0,
sp|Q1LUT1|EDC4_DANRE,Q1LUT1,EDC4_DANRE,edc4,1384,Danio rerio,3:Protein inferred from homology,Enhancer of mRNA-decapping protein 4,1,0.999,21,53,53,53,27,26,27,26,27,26,2287568640,2020420220,
sp|Q1LV17|I2BP1_DANRE,Q1LV17,I2BP1_DANRE,irf2bp1,605,Danio rerio,2:Experimental evidence at transcript level,Interferon regulatory factor 2-binding protein 1,1,0.999,5,7,7,7,6,1,6,1,6,1,277737408,113770472,
sp|Q1LV46|ABHEA_DANRE,Q1LV46,ABHEA_DANRE,abhd14a,270,Danio rerio,2:Experimental evidence at transcript level,Protein ABHD14A,1,0.999,6,9,9,9,4,5,4,5,4,5,248246080,231116880,
sp|Q1LVE8|SF3B3_DANRE,Q1LVE8,SF3B3_DANRE,sf3b3,1217,Danio rerio,2:Experimental evidence at transcript level,Splicing factor 3B subunit 3,1,0.999,53,192,192,192,101,91,101,91,101,91,17676314600,10956570600,
sp|Q1LVF0|LAMC1_DANRE,Q1LVF0,LAMC1_DANRE,lamc1,1593,Danio rerio,2:Experimental evidence at transcript level,Laminin subunit gamma-1,1,0.999,78,323,323,323,169,154,169,154,169,154,28103813100,19198246900,
sp|Q1LVI2|YJEN3_DANRE,Q1LVI2,YJEN3_DANRE,yjefn3,246,Danio rerio,1:Experimental evidence at protein level,YjeF N-terminal domain-containing 3,1,0.999,8,29,29,29,16,13,16,13,16,13,1053895040,3017464060,
sp|Q1LVN8|SELO1_DANRE,Q1LVN8,SELO1_DANRE,selenoo1,692,Danio rerio,3:Protein inferred from homology,"Protein adenylyltransferase SelO-1, mitochondrial",0.996,0.9888,4,4,4,4,2,2,2,2,2,2,334328224,438138176,
sp|Q1LVP6|ABRX1_DANRE,Q1LVP6,ABRX1_DANRE,abraxas1,391,Danio rerio,2:Experimental evidence at transcript level,BRCA1-A complex subunit Abraxas 1,0.8031,0.9929,1,1,1,1,0,1,0,1,0,1,0,1659170,
sp|Q1LW01|HE12_DANRE,Q1LW01,HE12_DANRE,he1.2,263,Danio rerio,1:Experimental evidence at protein level,Hatching enzyme 1.2,1,0.999,9,18,18,18,11,7,11,7,11,7,701533500,438896448,
sp|Q1LWB0|TXB1A_DANRE,Q1LWB0,TXB1A_DANRE,tax1bp1a,781,Danio rerio,2:Experimental evidence at transcript level,Tax1-binding protein 1 homolog A,0.6477,0.9783,2,2,1,2,2,0,1,0,2,0,26914112,0,
sp|Q1LWC2|T106B_DANRE,Q1LWC2,T106B_DANRE,tmem106b,267,Danio rerio,3:Protein inferred from homology,Transmembrane protein 106B,0.9929,0.9981,2,3,3,3,1,2,1,2,1,2,32922668,54990680,
sp|Q1LWJ6|ARPIN_DANRE,Q1LWJ6,ARPIN_DANRE,arpin,226,Danio rerio,2:Experimental evidence at transcript level,Arpin,0.4148,0.9602,1,1,1,1,1,0,1,0,1,0,40551976,0,
sp|Q1LWV4|LHX9_DANRE,Q1LWV4,LHX9_DANRE,lhx9,396,Danio rerio,2:Experimental evidence at transcript level,LIM/homeobox protein Lhx9,0.9509,0.9985,1,2,2,2,2,0,2,0,2,0,33897348,0,
sp|Q1LWV7|MEAK7_DANRE,Q1LWV7,MEAK7_DANRE,meak7,450,Danio rerio,2:Experimental evidence at transcript level,MTOR-associated protein MEAK7,0.8536,0.995,2,2,2,2,2,0,2,0,2,0,34439796,0,
sp|Q1LWX3|NTAQ1_DANRE,Q1LWX3,NTAQ1_DANRE,ntaq1,202,Danio rerio,2:Experimental evidence at transcript level,Protein N-terminal glutamine amidohydrolase,0.92490000000000006,0.9951,2,3,3,3,3,0,3,0,3,0,35555136,0,
sp|Q1LWZ0|CLXN_DANRE,Q1LWZ0,CLXN_DANRE,clxn,210,Danio rerio,2:Experimental evidence at transcript level,Calaxin,0.9642,0.9989,1,1,1,1,1,0,1,0,1,0,24426258,0,
sp|Q1LXC9|INT3_DANRE,Q1LXC9,INT3_DANRE,ints3,1017,Danio rerio,2:Experimental evidence at transcript level,Integrator complex subunit 3,1,0.9987,5,7,7,7,5,2,5,2,5,2,1805881470,1479220220,
sp|Q1LXE6|TT39C_DANRE,Q1LXE6,TT39C_DANRE,ttc39c,579,Danio rerio,2:Experimental evidence at transcript level,Tetratricopeptide repeat protein 39C,0.8963,0.9621,1,24,24,24,9,15,9,15,9,15,68033266000,29362649100,
sp|Q1LXK4|M10B1_DANRE,Q1LXK4,M10B1_DANRE,mov10b.1,1013,Danio rerio,2:Experimental evidence at transcript level,Putative helicase mov-10-B.1,1,0.999,12,17,13,17,9,8,7,6,9,8,404926848,223611552,
sp|Q1LXS2|PSMG2_DANRE,Q1LXS2,PSMG2_DANRE,psmg2,260,Danio rerio,2:Experimental evidence at transcript level,Proteasome assembly chaperone 2,1,0.9988,5,10,10,10,6,4,6,4,6,4,236864336,193045936,
sp|Q1LY10|FSD1_DANRE,Q1LY10,FSD1_DANRE,fsd1,495,Danio rerio,3:Protein inferred from homology,Fibronectin type III and SPRY domain-containing protein 1,1,0.999,6,7,7,7,4,3,4,3,4,3,112543696,355723648,
sp|Q1LY46|LETM1_DANRE,Q1LY46,LETM1_DANRE,letm1,757,Danio rerio,3:Protein inferred from homology,Mitochondrial proton/calcium exchanger protein,1,0.999,7,11,11,11,7,4,7,4,7,4,507450880,411285632,
sp|Q1LY51|ZN704_DANRE,Q1LY51,ZN704_DANRE,znf704,501,Danio rerio,3:Protein inferred from homology,Zinc finger protein 704,0.9382,0.9981,1,2,2,2,1,1,1,1,1,1,83067024,61606152,
sp|Q1LYB6|ATF1B_DANRE,Q1LYB6,ATF1B_DANRE,atp5if1b,107,Danio rerio,3:Protein inferred from homology,"ATPase inhibitor B, mitochondrial",1,0.999,9,15,15,15,9,6,9,6,9,6,428548224,297788064,
sp|Q1LYE3|ZN143_DANRE,Q1LYE3,ZN143_DANRE,znf143,623,Danio rerio,2:Experimental evidence at transcript level,Zinc finger protein 143,0.9906,0.9924,3,3,3,3,3,0,3,0,3,0,50440228,0,
sp|Q1LYG0|SPD2A_DANRE,Q1LYG0,SPD2A_DANRE,sh3pxd2a,1119,Danio rerio,3:Protein inferred from homology,SH3 and PX domain-containing protein 2A,1,0.9984,5,13,13,13,8,5,8,5,8,5,355505888,1237289090,
sp|Q1MTD3|MCES_DANRE,Q1MTD3,MCES_DANRE,rnmt,400,Danio rerio,3:Protein inferred from homology,mRNA cap guanine-N7 methyltransferase,1,0.999,14,52,52,52,28,24,28,24,28,24,2900409600,2016418430,
sp|Q1MTE5|ARL3_DANRE,Q1MTE5,ARL3_DANRE,arl3,182,Danio rerio,2:Experimental evidence at transcript level,ADP-ribosylation factor-like protein 3,1,0.999,9,33,33,33,18,15,18,15,18,15,3079783680,1916743420,
sp|Q1MTI4|TPISA_DANRE,Q1MTI4,TPISA_DANRE,tpi1a,248,Danio rerio,2:Experimental evidence at transcript level,Triosephosphate isomerase A,1,0.999,21,122,122,350,62,60,62,60,183,167,19051411500,13719630800,
sp|Q1RLX4|TPC11_DANRE,Q1RLX4,TPC11_DANRE,trappc11,1132,Danio rerio,2:Experimental evidence at transcript level,Trafficking protein particle complex subunit 11,1,0.999,4,4,4,4,4,0,4,0,4,0,275859264,0,
sp|Q1RLY6|KMO_DANRE,Q1RLY6,KMO_DANRE,kmo,474,Danio rerio,2:Experimental evidence at transcript level,Kynurenine 3-monooxygenase,1,0.999,13,25,25,25,16,9,16,9,16,9,788485760,292558752,
sp|Q1RM09|BASP1_DANRE,Q1RM09,BASP1_DANRE,basp1,197,Danio rerio,2:Experimental evidence at transcript level,Brain acid soluble protein 1 homolog,1,0.999,4,9,9,9,6,3,6,3,6,3,343311264,226112176,
sp|Q20JQ7|SC4AB_DANRE,Q20JQ7,SC4AB_DANRE,scn4ab,1784,Danio rerio,2:Experimental evidence at transcript level,Sodium channel protein type 4 subunit alpha B,0.7095,0.9881,1,1,1,1,1,0,1,0,1,0,0,0,
sp|Q29RB1|COG4_DANRE,Q29RB1,COG4_DANRE,cog4,781,Danio rerio,1:Experimental evidence at protein level,Conserved oligomeric Golgi complex subunit 4,0.9941,0.9989,3,4,4,4,3,1,3,1,3,1,76987200,27156846,
sp|Q29RB4|OLF3A_DANRE,Q29RB4,OLF3A_DANRE,olfml3a,390,Danio rerio,2:Experimental evidence at transcript level,Olfactomedin-like protein 3A,1,0.999,4,15,15,15,9,6,9,6,9,6,533552352,199370928,
sp|Q2I6J1|SHP2A_DANRE,Q2I6J1,SHP2A_DANRE,inppl1a,1266,Danio rerio,2:Experimental evidence at transcript level,"Phosphatidylinositol 3,4,5-trisphosphate 5-phosphatase 2A",0.966,0.999,1,2,2,2,1,1,1,1,1,1,0,86380480,
sp|Q2L6K8|CNPY4_DANRE,Q2L6K8,CNPY4_DANRE,cnpy4,217,Danio rerio,2:Experimental evidence at transcript level,Protein canopy 4,1,0.999,9,19,19,19,11,8,11,8,11,8,932700220,726566780,
sp|Q2L6L1|CNPY1_DANRE,Q2L6L1,CNPY1_DANRE,cnpy1,187,Danio rerio,1:Experimental evidence at protein level,Protein canopy-1,1,0.999,8,20,20,20,13,7,13,7,13,7,1253383170,825075140,
sp|Q2PW47|MED24_DANRE,Q2PW47,MED24_DANRE,med24,989,Danio rerio,2:Experimental evidence at transcript level,Mediator of RNA polymerase II transcription subunit 24,0.9995,0.9988,3,3,3,3,2,1,2,1,2,1,16578769,0,
sp|Q2QCI8|MED12_DANRE,Q2QCI8,MED12_DANRE,med12,2173,Danio rerio,2:Experimental evidence at transcript level,Mediator of RNA polymerase II transcription subunit 12,1,0.9935,6,9,9,9,4,5,4,5,4,5,394672480,990465660,
sp|Q2YDR3|IMPA3_DANRE,Q2YDR3,IMPA3_DANRE,bpnt2,341,Danio rerio,2:Experimental evidence at transcript level,Inositol monophosphatase 3,1,0.999,11,38,38,38,24,14,24,14,24,14,2271669760,1426213500,
sp|Q32LQ4|BHMT1_DANRE,Q32LQ4,BHMT1_DANRE,bhmt,400,Danio rerio,2:Experimental evidence at transcript level,Betaine--homocysteine S-methyltransferase 1,1,0.999,42,846,846,846,430,416,430,416,430,416,278253404000,225592738000,
sp|Q32LT7|TTYH3_DANRE,Q32LT7,TTYH3_DANRE,ttyh3b,560,Danio rerio,2:Experimental evidence at transcript level,Protein tweety homolog 3,0.9987,0.999,3,5,5,5,4,1,4,1,4,1,274793728,56228952,
sp|Q32LT9|P2011_DANRE,Q32LT9,P2011_DANRE,pm20d1.1,515,Danio rerio,2:Experimental evidence at transcript level,N-fatty-acyl-amino acid synthase/hydrolase PM20D1.1,0.9638,0.9989,1,1,1,1,1,0,1,0,1,0,29345240,0,
sp|Q32LU1|MIRO2_DANRE,Q32LU1,MIRO2_DANRE,rhot2,617,Danio rerio,2:Experimental evidence at transcript level,Mitochondrial Rho GTPase 2,1,0.999,5,11,9,11,6,5,5,4,6,5,315845792,204050656,
sp|Q32LU7|PTCD3_DANRE,Q32LU7,PTCD3_DANRE,ptcd3,667,Danio rerio,2:Experimental evidence at transcript level,Small ribosomal subunit protein mS39,0.9951,0.9989,2,3,3,3,2,1,2,1,2,1,141500320,87416416,
sp|Q32PL1|PP1R7_DANRE,Q32PL1,PP1R7_DANRE,ppp1r7,345,Danio rerio,2:Experimental evidence at transcript level,Protein phosphatase 1 regulatory subunit 7,1,0.999,23,83,83,83,42,41,42,41,42,41,7219830300,5129054700,
sp|Q32PR0|T55BA_DANRE,Q32PR0,T55BA_DANRE,tmem55ba,270,Danio rerio,2:Experimental evidence at transcript level,"Type I phosphatidylinositol 4,5-bisphosphate 4-phosphatase-A",0.3965,0.9572,1,1,0,1,0,1,0,0,0,1,0,56109768,sp|Q66I51|T55BB_DANRE
sp|Q32PV0|GULP1_DANRE,Q32PV0,GULP1_DANRE,gulp1,300,Danio rerio,2:Experimental evidence at transcript level,PTB domain-containing engulfment adapter protein 1,0.9975,0.9776,3,22,22,22,10,12,10,12,10,12,11088685100,9259307000,
sp|Q32PW3|TAF2_DANRE,Q32PW3,TAF2_DANRE,taf2,1191,Danio rerio,2:Experimental evidence at transcript level,Transcription initiation factor TFIID subunit 2,0.4329,0.963,1,1,1,1,1,0,1,0,1,0,0,0,
sp|Q3B736|ATGA1_DANRE,Q3B736,ATGA1_DANRE,atg101,218,Danio rerio,2:Experimental evidence at transcript level,Autophagy-related protein 101,1,0.999,6,8,8,8,7,1,7,1,7,1,239341072,64027380,
sp|Q3B752|KTHY_DANRE,Q3B752,KTHY_DANRE,dtymk,212,Danio rerio,2:Experimental evidence at transcript level,Thymidylate kinase,1,0.999,6,13,13,13,8,5,8,5,8,5,382723872,259545584,
sp|Q3B7H1|GALD1_DANRE,Q3B7H1,GALD1_DANRE,gatd1,213,Danio rerio,2:Experimental evidence at transcript level,Glutamine amidotransferase-like class 1 domain-containing protein 1,1,0.999,8,22,22,22,12,10,12,10,12,10,2203552510,1246385790,
sp|Q3B7Q7|NUBP2_DANRE,Q3B7Q7,NUBP2_DANRE,nubp2,268,Danio rerio,2:Experimental evidence at transcript level,Cytosolic Fe-S cluster assembly factor nubp2,0.6534,0.9635,2,4,4,4,2,2,2,2,2,2,369768192,94863024,
sp|Q3KRG3|TSR2_DANRE,Q3KRG3,TSR2_DANRE,tsr2,181,Danio rerio,2:Experimental evidence at transcript level,Pre-rRNA-processing protein TSR2 homolog,1,0.999,3,5,5,5,2,3,2,3,2,3,184869120,276930400,
sp|Q3LSS0|C19L2_DANRE,Q3LSS0,C19L2_DANRE,cwf19l2,960,Danio rerio,2:Experimental evidence at transcript level,CWF19-like protein 2,0.9996,0.9989,3,4,4,4,2,2,2,2,2,2,84701024,60530152,
sp|Q498P2|RT35_DANRE,Q498P2,RT35_DANRE,mrps35,330,Danio rerio,2:Experimental evidence at transcript level,Small ribosomal subunit protein mS35,0.833,0.9941,1,2,2,2,1,1,1,1,1,1,2798732.8,2259177.8,
sp|Q49HM9|GRK7A_DANRE,Q49HM9,GRK7A_DANRE,grk7a,549,Danio rerio,1:Experimental evidence at protein level,Rhodopsin kinase grk7a,1,0.999,20,52,50,52,26,26,25,25,26,26,2202269180,1735621630,
sp|Q4G3H4|IKKA_DANRE,Q4G3H4,IKKA_DANRE,chuk,758,Danio rerio,1:Experimental evidence at protein level,Inhibitor of nuclear factor kappa-B kinase subunit alpha,0.9704,0.9873,4,8,6,8,4,4,3,3,4,4,292313664,71090016,
sp|Q4H4B6|SCRIB_DANRE,Q4H4B6,SCRIB_DANRE,scrib,1724,Danio rerio,1:Experimental evidence at protein level,Protein scribble homolog,1,0.999,12,20,20,20,12,8,12,8,12,8,694772480,266340288,
sp|Q4KM14|TSP1L_DANRE,Q4KM14,TSP1L_DANRE,trnau1apl,316,Danio rerio,2:Experimental evidence at transcript level,tRNA selenocysteine 1-associated protein 1-like,1,0.999,10,32,32,32,18,14,18,14,18,14,3814117630,4764705800,
sp|Q4KMC8|ALDCA_DANRE,Q4KMC8,ALDCA_DANRE,aldoca,364,Danio rerio,2:Experimental evidence at transcript level,Fructose-bisphosphate aldolase C-A,1,0.999,16,62,37,143,36,26,23,14,75,68,31444846600,23271622700,
sp|Q4KMD7|STPAP_DANRE,Q4KMD7,STPAP_DANRE,tut1,797,Danio rerio,2:Experimental evidence at transcript level,Speckle targeted PIP5K1A-regulated poly(A) polymerase,0.9998,0.9984,4,6,6,6,4,2,4,2,4,2,245485216,73778576,
sp|Q4KME6|GGYF2_DANRE,Q4KME6,GGYF2_DANRE,gigyf2,1329,Danio rerio,2:Experimental evidence at transcript level,GRB10-interacting GYF protein 2,1,0.999,7,14,14,14,9,5,9,5,9,5,358242240,233023408,
sp|Q4QRF4|H32_DANRE,Q4QRF4,H32_DANRE,zgc:113984,136,Danio rerio,2:Experimental evidence at transcript level,Histone H3.2,1,0.999,15,310,12,310,173,137,7,5,173,137,222439588000,145599627000,
sp|Q4QRF7|LEG1B_DANRE,Q4QRF7,LEG1B_DANRE,leg1b,364,Danio rerio,1:Experimental evidence at protein level,Protein leg1b,0.9865,0.9987,5,1,1,18,1,0,1,0,13,5,230842352,0,
sp|Q4QRJ7|EIF2A_DANRE,Q4QRJ7,EIF2A_DANRE,eif2a,580,Danio rerio,2:Experimental evidence at transcript level,Eukaryotic translation initiation factor 2A,1,0.999,20,68,68,68,41,27,41,27,41,27,4460480500,3153381890,
sp|Q4QRK0|MAP11_DANRE,Q4QRK0,MAP11_DANRE,metap1,386,Danio rerio,2:Experimental evidence at transcript level,Methionine aminopeptidase 1,1,0.999,22,104,104,104,58,46,58,46,58,46,5570427400,3720493060,
sp|Q4TVV3|DDX46_DANRE,Q4TVV3,DDX46_DANRE,ddx46,1018,Danio rerio,2:Experimental evidence at transcript level,Probable ATP-dependent RNA helicase DDX46,1,0.9983,6,8,8,8,3,5,3,5,3,5,182346240,205492400,
sp|Q4U0S5|PAF1_DANRE,Q4U0S5,PAF1_DANRE,paf1,503,Danio rerio,1:Experimental evidence at protein level,RNA polymerase II-associated factor 1 homolog,0.9943,0.9986,2,3,3,3,2,1,2,1,2,1,43221684,11281532,
sp|Q4V8T0|MIOX_DANRE,Q4V8T0,MIOX_DANRE,miox,278,Danio rerio,2:Experimental evidence at transcript level,Inositol oxygenase,1,0.999,4,5,5,5,4,1,4,1,4,1,148778496,28435648,
sp|Q4V8U5|ANO10_DANRE,Q4V8U5,ANO10_DANRE,ano10,646,Danio rerio,2:Experimental evidence at transcript level,Anoctamin-10,1,0.999,9,21,21,21,11,10,11,10,11,10,593679100,355743936,
sp|Q4V8W7|UBTD1_DANRE,Q4V8W7,UBTD1_DANRE,ubtd1,227,Danio rerio,2:Experimental evidence at transcript level,Ubiquitin domain-containing protein 1,0.9973,0.999,4,7,3,7,4,3,2,1,4,3,890589890,102976048,
sp|Q4V8X0|TPRA1_DANRE,Q4V8X0,TPRA1_DANRE,tpra1,378,Danio rerio,2:Experimental evidence at transcript level,Transmembrane protein adipocyte-associated 1 homolog,0.5461,0.9762,1,9,9,9,6,3,6,3,6,3,1073241410,704314300,
sp|Q4V8X4|ACBD6_DANRE,Q4V8X4,ACBD6_DANRE,acbd6,300,Danio rerio,2:Experimental evidence at transcript level,Acyl-CoA-binding domain-containing protein 6,1,0.999,6,10,10,10,6,4,6,4,6,4,538831620,370553664,
sp|Q4V8Y6|ERGI1_DANRE,Q4V8Y6,ERGI1_DANRE,ergic1,290,Danio rerio,2:Experimental evidence at transcript level,Endoplasmic reticulum-Golgi intermediate compartment protein 1,0.9499,0.9979,2,5,5,5,3,2,3,2,3,2,75912840,39441324,
sp|Q4V909|CCD22_DANRE,Q4V909,CCD22_DANRE,ccdc22,639,Danio rerio,2:Experimental evidence at transcript level,Coiled-coil domain-containing protein 22,1,0.9987,5,8,8,8,4,4,4,4,4,4,162385728,93178904,
sp|Q4V920|PACN1_DANRE,Q4V920,PACN1_DANRE,pacsin1b,445,Danio rerio,1:Experimental evidence at protein level,Protein kinase C and casein kinase substrate in neurons protein 1,1,0.999,14,31,31,31,16,15,16,15,16,15,1199043330,482927840,
sp|Q4V9P6|ADAL_DANRE,Q4V9P6,ADAL_DANRE,adal,348,Danio rerio,2:Experimental evidence at transcript level,Adenosine deaminase-like protein,1,0.999,12,27,27,27,16,11,16,11,16,11,1409488640,671831940,
sp|Q4V9P9|NOL11_DANRE,Q4V9P9,NOL11_DANRE,nol11,708,Danio rerio,2:Experimental evidence at transcript level,Nucleolar protein 11-like,1,0.999,13,22,22,22,12,10,12,10,12,10,1003714110,537943040,
sp|Q4VBI2|IR3IP_DANRE,Q4VBI2,IR3IP_DANRE,ier3ip1,82,Danio rerio,3:Protein inferred from homology,Immediate early response 3-interacting protein 1,0.9805,0.999,2,3,3,3,2,1,2,1,2,1,69533552,31256150,
sp|Q4VBI7|STX18_DANRE,Q4VBI7,STX18_DANRE,stx18,314,Danio rerio,2:Experimental evidence at transcript level,Syntaxin-18,1,0.999,4,4,4,4,2,2,2,2,2,2,86176800,15895716,
sp|Q4VBS4|MAP12_DANRE,Q4VBS4,MAP12_DANRE,metap1d,338,Danio rerio,2:Experimental evidence at transcript level,"Methionine aminopeptidase 1D, mitochondrial",0.9998,0.9982,3,3,3,3,3,0,3,0,3,0,156018832,0,
sp|Q4VBT1|FA1B1_DANRE,Q4VBT1,FA1B1_DANRE,fabp1b.1,128,Danio rerio,2:Experimental evidence at transcript level,Fatty acid binding protein 1-B.1,1,0.999,7,274,274,274,135,139,135,139,135,139,101262344000,70010765000,
sp|Q4VBV9|NIT2_DANRE,Q4VBV9,NIT2_DANRE,nit2,277,Danio rerio,2:Experimental evidence at transcript level,Omega-amidase NIT2,1,0.999,18,64,64,64,38,26,38,26,38,26,5295004700,2805234180,
sp|Q4VBW0|MTX3_DANRE,Q4VBW0,MTX3_DANRE,mtx3,313,Danio rerio,2:Experimental evidence at transcript level,Metaxin-3,0.5437,0.976,1,2,2,2,1,1,1,1,1,1,10620448,12266734,
sp|Q4VSN1|DUSTY_DANRE,Q4VSN1,DUSTY_DANRE,dstyk,885,Danio rerio,2:Experimental evidence at transcript level,Dual serine/threonine and tyrosine protein kinase,0.8811,0.9833,1,1,1,1,1,0,1,0,1,0,173921.52,0,
sp|Q502D1|GLOD5_DANRE,Q502D1,GLOD5_DANRE,glod5,163,Danio rerio,2:Experimental evidence at transcript level,Glyoxalase domain-containing protein 5,1,0.999,4,21,21,21,12,9,12,9,12,9,1660578560,1125949180,
sp|Q502G5|CA050_DANRE,Q502G5,CA050_DANRE,zgc:112255,189,Danio rerio,2:Experimental evidence at transcript level,Uncharacterized protein C1orf50 homolog,1,0.9989,5,9,9,9,5,4,5,4,5,4,115051160,53032512,
sp|Q502H1|AAMDC_DANRE,Q502H1,AAMDC_DANRE,aamdc,122,Danio rerio,2:Experimental evidence at transcript level,Mth938 domain-containing protein,0.7643,0.991,1,2,2,2,1,1,1,1,1,1,37986352,12416376,
sp|Q502I9|FCHO2_DANRE,Q502I9,FCHO2_DANRE,fcho2,848,Danio rerio,2:Experimental evidence at transcript level,F-BAR domain only protein 2,1,0.999,10,17,15,17,13,4,12,3,13,4,564876990,312330496,
sp|Q502J0|PCAT2_DANRE,Q502J0,PCAT2_DANRE,lpcat2,529,Danio rerio,2:Experimental evidence at transcript level,Lysophosphatidylcholine acyltransferase 2,1,0.9989,4,5,5,5,3,2,3,2,3,2,132033984,54763552,
sp|Q502J7|DCTN6_DANRE,Q502J7,DCTN6_DANRE,dctn6,195,Danio rerio,2:Experimental evidence at transcript level,Dynactin subunit 6,0.9996,0.9989,3,6,6,6,3,3,3,3,3,3,280716896,165308464,
sp|Q502K2|SAMH1_DANRE,Q502K2,SAMH1_DANRE,samhd1,622,Danio rerio,2:Experimental evidence at transcript level,Deoxynucleoside triphosphate triphosphohydrolase SAMHD1,1,0.999,3,4,4,4,3,1,3,1,3,1,54687532,25080304,
sp|Q502K3|ANR52_DANRE,Q502K3,ANR52_DANRE,ankrd52,1071,Danio rerio,2:Experimental evidence at transcript level,Serine/threonine-protein phosphatase 6 regulatory ankyrin repeat subunit C,0.9383,0.9981,2,3,3,3,3,0,3,0,3,0,81301376,0,
sp|Q502K9|SELT2_DANRE,Q502K9,SELT2_DANRE,selenot2,210,Danio rerio,2:Experimental evidence at transcript level,Selenoprotein T2,0.3998,0.9578,1,2,2,2,1,1,1,1,1,1,55810984,49829200,
sp|Q502L2|PGAM5_DANRE,Q502L2,PGAM5_DANRE,pgam5,289,Danio rerio,2:Experimental evidence at transcript level,"Serine/threonine-protein phosphatase PGAM5, mitochondrial",1,0.999,6,10,10,10,4,6,4,6,4,6,317753504,390795168,
sp|Q502M5|EDC3_DANRE,Q502M5,EDC3_DANRE,edc3,507,Danio rerio,1:Experimental evidence at protein level,Enhancer of mRNA-decapping protein 3,0.9989,0.9984,3,4,4,4,3,1,3,1,3,1,143840528,0,
sp|Q503C8|NUDC1_DANRE,Q503C8,NUDC1_DANRE,nudcd1,585,Danio rerio,2:Experimental evidence at transcript level,NudC domain-containing protein 1,1,0.999,14,26,26,26,16,10,16,10,16,10,964721660,8349911000,
sp|Q503E1|INT11_DANRE,Q503E1,INT11_DANRE,cpsf3l,598,Danio rerio,2:Experimental evidence at transcript level,Integrator complex subunit 11,1,0.9989,11,17,17,17,12,5,12,5,12,5,1594042110,510953760,
sp|Q503E9|IMA6_DANRE,Q503E9,IMA6_DANRE,kpna5,539,Danio rerio,2:Experimental evidence at transcript level,Importin subunit alpha-6,1,0.999,6,10,10,10,6,4,6,4,6,4,245877680,185017376,
sp|Q503I8|NGLY1_DANRE,Q503I8,NGLY1_DANRE,ngly1,644,Danio rerio,2:Experimental evidence at transcript level,Peptide-N(4)-(N-acetyl-beta-glucosaminyl)asparagine amidase,1,0.999,9,17,17,17,11,6,11,6,11,6,907822400,551473220,
sp|Q503K9|S100Z_DANRE,Q503K9,S100Z_DANRE,s100z,99,Danio rerio,1:Experimental evidence at protein level,Protein S100-Z,0.9633,0.9989,1,1,1,1,1,0,1,0,1,0,8488434,0,
sp|Q503L4|IAH1_DANRE,Q503L4,IAH1_DANRE,iah1,238,Danio rerio,2:Experimental evidence at transcript level,Isoamyl acetate-hydrolyzing esterase 1 homolog,1,0.999,6,14,14,14,8,6,8,6,8,6,464281536,284680832,
sp|Q503L9|NXN_DANRE,Q503L9,NXN_DANRE,nxn,418,Danio rerio,2:Experimental evidence at transcript level,Nucleoredoxin,1,0.999,6,18,18,18,10,8,10,8,10,8,788058690,509920448,
sp|Q503P2|NIP7_DANRE,Q503P2,NIP7_DANRE,nip7,180,Danio rerio,2:Experimental evidence at transcript level,60S ribosome subunit biogenesis protein NIP7 homolog,1,0.999,8,14,14,14,9,5,9,5,9,5,296837184,166164944,
sp|Q503S6|LTOR3_DANRE,Q503S6,LTOR3_DANRE,lamtor3,124,Danio rerio,2:Experimental evidence at transcript level,Ragulator complex protein LAMTOR3,1,0.999,3,9,9,9,6,3,6,3,6,3,405793344,255939584,
sp|Q503U0|LMO3_DANRE,Q503U0,LMO3_DANRE,lmo3,145,Danio rerio,2:Experimental evidence at transcript level,LIM domain only protein 3,0.9999,0.9987,4,7,0,7,3,4,0,0,3,4,126276432,781438210,sp|Q8JFQ2|RBTN1_DANRE
sp|Q503U3|MFFA_DANRE,Q503U3,MFFA_DANRE,zgc:110130,275,Danio rerio,2:Experimental evidence at transcript level,Mitochondrial fission factor homolog A,0.879,0.996,1,2,2,2,1,1,1,1,1,1,34914156,13634725,
sp|Q503V0|CHMP6_DANRE,Q503V0,CHMP6_DANRE,chmp6,206,Danio rerio,2:Experimental evidence at transcript level,Charged multivesicular body protein 6,1,0.999,14,47,47,47,27,20,27,20,27,20,11412018200,1897243780,
sp|Q503V9|ENDUB_DANRE,Q503V9,ENDUB_DANRE,endoub,282,Danio rerio,2:Experimental evidence at transcript level,Uridylate-specific endoribonuclease B,1,0.999,10,26,26,26,15,11,15,11,15,11,3541500160,2075037060,
sp|Q503W7|ATD1B_DANRE,Q503W7,ATD1B_DANRE,atad1b,362,Danio rerio,2:Experimental evidence at transcript level,Outer mitochondrial transmembrane helix translocase,0.8586,0.9952,1,3,0,3,2,1,0,0,2,1,1287747,0,sp|Q7ZZ25|ATD1A_DANRE
sp|Q503Y4|OVCA2_DANRE,Q503Y4,OVCA2_DANRE,ovca2,227,Danio rerio,2:Experimental evidence at transcript level,Esterase OVCA2,0.9806,0.999,2,2,2,2,2,0,2,0,2,0,59189984,0,
sp|Q503Y7|PIN4_DANRE,Q503Y7,PIN4_DANRE,pin4,128,Danio rerio,2:Experimental evidence at transcript level,Peptidyl-prolyl cis-trans isomerase NIMA-interacting 4,1,0.9989,4,8,8,8,6,2,6,2,6,2,373358304,141588480,
sp|Q504A5|TPMT_DANRE,Q504A5,TPMT_DANRE,tpmt,232,Danio rerio,2:Experimental evidence at transcript level,Probable thiopurine S-methyltransferase,1,0.999,12,36,36,36,24,12,24,12,24,12,2072465920,947554750,
sp|Q504J1|CASPB_DANRE,Q504J1,CASPB_DANRE,caspb,404,Danio rerio,1:Experimental evidence at protein level,Caspase b,1,0.999,20,78,74,78,42,36,40,34,42,36,6252383700,4558572000,
sp|Q52PJ5|DPYL3_DANRE,Q52PJ5,DPYL3_DANRE,dpysl3,567,Danio rerio,2:Experimental evidence at transcript level,Dihydropyrimidinase-related protein 3,1,0.999,35,277,277,277,153,124,153,124,153,124,32153298900,29394276400,
sp|Q561X9|DHRS6_DANRE,Q561X9,DHRS6_DANRE,bdh2,245,Danio rerio,2:Experimental evidence at transcript level,Dehydrogenase/reductase SDR family member 6,1,0.999,18,83,83,83,45,38,45,38,45,38,5906847700,4007689470,
sp|Q561Y0|DAA10_DANRE,Q561Y0,DAA10_DANRE,dnaaf10,358,Danio rerio,2:Experimental evidence at transcript level,Dynein axonemal assembly factor 10,1,0.9988,8,11,11,11,9,2,9,2,9,2,202203120,30565332,
sp|Q566N0|ENPP4_DANRE,Q566N0,ENPP4_DANRE,enpp4,459,Danio rerio,2:Experimental evidence at transcript level,Bis(5'-adenosyl)-triphosphatase enpp4,0.9975,0.9977,3,3,3,3,2,1,2,1,2,1,74592056,574189.25,
sp|Q566S6|DRS7B_DANRE,Q566S6,DRS7B_DANRE,dhrs7b,309,Danio rerio,2:Experimental evidence at transcript level,Dehydrogenase/reductase SDR family member 7B,0.6569,0.9849,1,1,1,1,1,0,1,0,1,0,9289675,0,
sp|Q566U4|KFA_DANRE,Q566U4,KFA_DANRE,afmid,293,Danio rerio,2:Experimental evidence at transcript level,Kynurenine formamidase,1,0.999,8,15,15,15,9,6,9,6,9,6,858161920,646842750,
sp|Q566V0|ARCH_DANRE,Q566V0,ARCH_DANRE,zbtb8os,162,Danio rerio,2:Experimental evidence at transcript level,Protein archease,1,0.999,8,30,30,30,16,14,16,14,16,14,1956923780,1257422340,
sp|Q566W7|SNX30_DANRE,Q566W7,SNX30_DANRE,snx30,430,Danio rerio,2:Experimental evidence at transcript level,Sorting nexin-30,0.9999,0.999,3,5,5,5,3,2,3,2,3,2,174056944,21476296,
sp|Q566Y8|MGN_DANRE,Q566Y8,MGN_DANRE,magoh,147,Danio rerio,2:Experimental evidence at transcript level,Protein mago nashi homolog,1,0.999,14,88,88,88,49,39,49,39,49,39,8687920100,5363322900,
sp|Q567B1|OTU1_DANRE,Q567B1,OTU1_DANRE,yod1,301,Danio rerio,2:Experimental evidence at transcript level,Ubiquitin thioesterase OTU1,1,0.999,8,19,19,19,11,8,11,8,11,8,1210187780,491649952,
sp|Q567E6|CQ10B_DANRE,Q567E6,CQ10B_DANRE,coq10b,238,Danio rerio,2:Experimental evidence at transcript level,"Coenzyme Q-binding protein COQ10 homolog B, mitochondrial",0.925,0.9976,1,1,1,1,1,0,1,0,1,0,14369796,0,
sp|Q567G2|WDR73_DANRE,Q567G2,WDR73_DANRE,wdr73,376,Danio rerio,2:Experimental evidence at transcript level,WD repeat-containing protein 73,0.6866,0.9868,1,1,1,1,1,0,1,0,1,0,3444829,0,
sp|Q567V6|EIF3K_DANRE,Q567V6,EIF3K_DANRE,eif3k,219,Danio rerio,2:Experimental evidence at transcript level,Eukaryotic translation initiation factor 3 subunit K,1,0.999,13,46,46,46,26,20,26,20,26,20,3906053890,2480265220,
sp|Q567W6|DPH1_DANRE,Q567W6,DPH1_DANRE,dph1,381,Danio rerio,2:Experimental evidence at transcript level,2-(3-amino-3-carboxypropyl)histidine synthase subunit 1,1,0.9988,3,5,5,5,3,2,3,2,3,2,216856496,129251096,
sp|Q567Z6|CRIPT_DANRE,Q567Z6,CRIPT_DANRE,cript,101,Danio rerio,3:Protein inferred from homology,Cysteine-rich PDZ-binding protein,0.967,0.999,2,2,2,2,2,0,2,0,2,0,35002100,0,
sp|Q567Z7|BUD31_DANRE,Q567Z7,BUD31_DANRE,bud31,144,Danio rerio,2:Experimental evidence at transcript level,Protein BUD31 homolog,1,0.9989,6,10,10,10,5,5,5,5,5,5,310459232,171044528,
sp|Q568D5|BABA2_DANRE,Q568D5,BABA2_DANRE,babam2,386,Danio rerio,1:Experimental evidence at protein level,BRISC and BRCA1-A complex member 2,1,0.9989,4,4,4,4,4,0,4,0,4,0,133734528,0,
sp|Q568F6|PURA2_DANRE,Q568F6,PURA2_DANRE,adss2,455,Danio rerio,2:Experimental evidence at transcript level,Adenylosuccinate synthetase isozyme 2,1,0.999,26,62,62,77,29,33,29,33,39,38,2875689470,3368820990,
sp|Q568K2|PP1RB_DANRE,Q568K2,PP1RB_DANRE,ppp1r11,122,Danio rerio,1:Experimental evidence at protein level,E3 ubiquitin-protein ligase PPP1R11,1,0.999,3,8,8,8,5,3,5,3,5,3,572700930,393236960,
sp|Q568K5|NAA40_DANRE,Q568K5,NAA40_DANRE,naa40,237,Danio rerio,2:Experimental evidence at transcript level,N-alpha-acetyltransferase 40,1,0.999,3,8,8,8,4,4,4,4,4,4,132350608,174885904,
sp|Q568K9|FA50A_DANRE,Q568K9,FA50A_DANRE,fam50a,341,Danio rerio,2:Experimental evidence at transcript level,Protein FAM50A,1,0.999,7,21,21,21,13,8,13,8,13,8,1170607620,786044610,
sp|Q568L5|A1A1B_DANRE,Q568L5,A1A1B_DANRE,akr1a1b,324,Danio rerio,2:Experimental evidence at transcript level,Aldo-keto reductase family 1 member A1-B,1,0.999,30,168,168,168,85,83,85,83,85,83,15858980900,12552463400,
sp|Q568M3|CRLF3_DANRE,Q568M3,CRLF3_DANRE,crlf3,444,Danio rerio,2:Experimental evidence at transcript level,Cytokine receptor-like factor 3,1,0.999,4,6,6,6,5,1,5,1,5,1,137717424,26461574,
sp|Q568N4|T10B_DANRE,Q568N4,T10B_DANRE,timm10b,202,Danio rerio,2:Experimental evidence at transcript level,Mitochondrial import inner membrane translocase subunit Tim10 B,0.6879,0.9869,1,2,2,2,1,1,1,1,1,1,0,0,
sp|Q568P1|MESH1_DANRE,Q568P1,MESH1_DANRE,hddc3,180,Danio rerio,2:Experimental evidence at transcript level,"Guanosine-3',5'-bis(diphosphate) 3'-pyrophosphohydrolase MESH1",1,0.999,9,33,33,33,19,14,19,14,19,14,3530085120,3016502530,
sp|Q568T4|HIKES_DANRE,Q568T4,HIKES_DANRE,hikeshi,197,Danio rerio,2:Experimental evidence at transcript level,Protein Hikeshi,0.9972,0.9988,2,2,2,2,1,1,1,1,1,1,19735306,325506432,
sp|Q568V3|FBX50_DANRE,Q568V3,FBX50_DANRE,nccrp1,237,Danio rerio,2:Experimental evidence at transcript level,F-box only protein 50,1,0.999,14,89,89,89,48,41,48,41,48,41,11864707100,9635696600,
sp|Q568W0|SELW_DANRE,Q568W0,SELW_DANRE,selenow,86,Danio rerio,3:Protein inferred from homology,Selenoprotein W,1,0.999,4,18,18,18,8,10,8,10,8,10,582115260,405429152,
sp|Q56A35|ARP2B_DANRE,Q56A35,ARP2B_DANRE,actr2b,394,Danio rerio,2:Experimental evidence at transcript level,Actin-related protein 2-B,1,0.999,27,15,15,157,10,5,10,5,85,72,1159793410,530245664,
sp|Q56A55|MITOS_DANRE,Q56A55,MITOS_DANRE,abcb8,714,Danio rerio,2:Experimental evidence at transcript level,Mitochondrial potassium channel ATP-binding subunit,0.6682,0.973,2,2,2,2,1,1,1,1,1,1,34335020,10677111,
sp|Q58EB4|HIBCH_DANRE,Q58EB4,HIBCH_DANRE,hibch,382,Danio rerio,2:Experimental evidence at transcript level,"3-hydroxyisobutyryl-CoA hydrolase, mitochondrial",1,0.999,19,105,105,105,54,51,54,51,54,51,8048840200,6091421700,
sp|Q58ED9|NAA20_DANRE,Q58ED9,NAA20_DANRE,naa20,178,Danio rerio,2:Experimental evidence at transcript level,N-alpha-acetyltransferase 20,1,0.999,5,5,5,5,4,1,4,1,4,1,128516688,8275275,
sp|Q58EE9|GFAP_DANRE,Q58EE9,GFAP_DANRE,gfap,444,Danio rerio,1:Experimental evidence at protein level,Glial fibrillary acidic protein,1,0.999,36,113,105,220,53,60,47,58,107,113,26566807600,52715848000,
sp|Q58EG2|ERLN1_DANRE,Q58EG2,ERLN1_DANRE,erlin1,342,Danio rerio,2:Experimental evidence at transcript level,Erlin-1,0.9998,0.999,3,6,6,6,4,2,4,2,4,2,491568480,349620256,
sp|Q58EG3|NECT3_DANRE,Q58EG3,NECT3_DANRE,nectin3,574,Danio rerio,2:Experimental evidence at transcript level,Nectin-3-like protein,0.8557,0.9951,2,2,2,2,2,0,2,0,2,0,76194848,0,
sp|Q58EJ9|MARC1_DANRE,Q58EJ9,MARC1_DANRE,mtarc1,325,Danio rerio,2:Experimental evidence at transcript level,Mitochondrial amidoxime-reducing component 1,1,0.999,8,16,16,16,8,8,8,8,8,8,677510270,851088450,
sp|Q58EK3|PLCX3_DANRE,Q58EK3,PLCX3_DANRE,plcxd3,322,Danio rerio,2:Experimental evidence at transcript level,PI-PLC X domain-containing protein 3,0.9614,0.9988,1,1,1,1,1,0,1,0,1,0,30699440,0,
sp|Q58EL2|NACHO_DANRE,Q58EL2,NACHO_DANRE,tmem35a,160,Danio rerio,2:Experimental evidence at transcript level,Novel acetylcholine receptor chaperone,0.9996,0.9989,3,6,6,6,3,3,3,3,3,3,393836544,215801056,
sp|Q58EM4|ARMT1_DANRE,Q58EM4,ARMT1_DANRE,armt1,448,Danio rerio,2:Experimental evidence at transcript level,Damage-control phosphatase ARMT1,1,0.999,9,11,11,11,9,2,9,2,9,2,507527360,59030376,
sp|Q5BJA5|H2B1_DANRE,Q5BJA5,H2B1_DANRE,zgc:112234,124,Danio rerio,2:Experimental evidence at transcript level,Histone H2B 1/2,1,0.999,17,375,0,375,195,180,0,0,195,180,149513077000,108877930000,sp|Q6PC60|H2B3_DANRE
sp|Q5BJI7|SMY2A_DANRE,Q5BJI7,SMY2A_DANRE,smyd2a,435,Danio rerio,2:Experimental evidence at transcript level,N-lysine methyltransferase SMYD2-A,1,0.999,14,30,30,30,17,13,17,13,17,13,1031494340,490743232,
sp|Q5BJI9|SPCS2_DANRE,Q5BJI9,SPCS2_DANRE,spcs2,201,Danio rerio,2:Experimental evidence at transcript level,Signal peptidase complex subunit 2,1,0.999,11,27,27,27,13,14,13,14,13,14,1603905660,1339155710,
sp|Q5BJJ5|HDHD2_DANRE,Q5BJJ5,HDHD2_DANRE,hdhd2,262,Danio rerio,2:Experimental evidence at transcript level,Haloacid dehalogenase-like hydrolase domain-containing protein 2,1,0.9975,6,13,13,13,6,7,6,7,6,7,987596030,527549632,
sp|Q5BJJ6|MAT2B_DANRE,Q5BJJ6,MAT2B_DANRE,mat2b,323,Danio rerio,2:Experimental evidence at transcript level,Methionine adenosyltransferase 2 subunit beta,1,0.999,8,15,15,15,8,7,8,7,8,7,5649844700,2266599420,
sp|Q5BJJ7|BCCIP_DANRE,Q5BJJ7,BCCIP_DANRE,bccip,301,Danio rerio,2:Experimental evidence at transcript level,Protein BCCIP homolog,1,0.999,9,22,22,22,13,9,13,9,13,9,1124910080,525527552,
sp|Q5BKW7|ENPP6_DANRE,Q5BKW7,ENPP6_DANRE,enpp6,438,Danio rerio,2:Experimental evidence at transcript level,Glycerophosphocholine cholinephosphodiesterase ENPP6,1,0.999,3,9,9,9,6,3,6,3,6,3,210405024,103663336,
sp|Q5BKW9|ASGL1_DANRE,Q5BKW9,ASGL1_DANRE,asrgl1,310,Danio rerio,2:Experimental evidence at transcript level,Isoaspartyl peptidase/L-asparaginase,1,0.999,19,50,50,50,28,22,28,22,28,22,1883041410,1960767360,
sp|Q5BL28|DS7CB_DANRE,Q5BL28,DS7CB_DANRE,dhrs7cb,318,Danio rerio,2:Experimental evidence at transcript level,Dehydrogenase/reductase SDR family member 7C-B,0.8517,0.9768,2,2,2,2,2,0,2,0,2,0,22661894,0,
sp|Q5BL31|ILRUN_DANRE,Q5BL31,ILRUN_DANRE,ilrun,283,Danio rerio,2:Experimental evidence at transcript level,Protein ILRUN,0.984,0.999,1,2,2,2,2,0,2,0,2,0,37870780,0,
sp|Q5BLD8|MT21A_DANRE,Q5BLD8,MT21A_DANRE,mettl21a,218,Danio rerio,2:Experimental evidence at transcript level,Protein N-lysine methyltransferase METTL21A,0.9597,0.9988,1,1,1,1,0,1,0,1,0,1,0,1378568.1,
sp|Q5BLE8|RETST_DANRE,Q5BLE8,RETST_DANRE,retsat,607,Danio rerio,1:Experimental evidence at protein level,"All-trans-retinol 13,14-reductase",1,0.999,18,34,34,34,19,15,19,15,19,15,1474492930,808772100,
sp|Q5BLF0|NMD3_DANRE,Q5BLF0,NMD3_DANRE,nmd3,505,Danio rerio,2:Experimental evidence at transcript level,60S ribosomal export protein NMD3,0.9999,0.999,4,8,8,8,3,5,3,5,3,5,224515360,242152624,
sp|Q5CZP2|HSF4_DANRE,Q5CZP2,HSF4_DANRE,hsf4,441,Danio rerio,2:Experimental evidence at transcript level,Heat shock factor protein 4,0.7609,0.9909,1,1,1,1,1,0,1,0,1,0,20986628,0,
sp|Q5CZR5|AEP1_DANRE,Q5CZR5,AEP1_DANRE,aep1,315,Danio rerio,1:Experimental evidence at protein level,Aerolysin-like protein,1,0.999,15,212,212,212,119,93,119,93,119,93,45527572000,27022366700,
sp|Q5CZV0|TM182_DANRE,Q5CZV0,TM182_DANRE,tmem182a,248,Danio rerio,2:Experimental evidence at transcript level,Transmembrane protein 182,1,0.999,3,10,10,10,4,6,4,6,4,6,948280320,504016640,
sp|Q5D013|EFMT2_DANRE,Q5D013,EFMT2_DANRE,eef1akmt2,233,Danio rerio,2:Experimental evidence at transcript level,EEF1A lysine methyltransferase 2,0.9459,0.9983,1,1,1,1,1,0,1,0,1,0,25946566,0,
sp|Q5D014|NATD1_DANRE,Q5D014,NATD1_DANRE,natd1,110,Danio rerio,3:Protein inferred from homology,Protein NATD1,0.9998,0.9978,3,4,4,4,2,2,2,2,2,2,42794012,28450054,
sp|Q5D018|RBM8A_DANRE,Q5D018,RBM8A_DANRE,rbm8a,174,Danio rerio,2:Experimental evidence at transcript level,RNA-binding protein 8A,1,0.999,12,94,94,94,48,46,48,46,48,46,11211585500,8161382900,
sp|Q5EAR5|TRPT1_DANRE,Q5EAR5,TRPT1_DANRE,trpt1,225,Danio rerio,2:Experimental evidence at transcript level,tRNA 2'-phosphotransferase 1,0.9906,0.9933,3,3,3,3,3,0,3,0,3,0,358933728,0,
sp|Q5I0F6|KAP0_DANRE,Q5I0F6,KAP0_DANRE,prkar1aa,379,Danio rerio,1:Experimental evidence at protein level,cAMP-dependent protein kinase type I-alpha regulatory subunit,1,0.999,20,76,76,76,37,39,37,39,37,39,4625642000,3423548160,
sp|Q5M7Y0|CERT_DANRE,Q5M7Y0,CERT_DANRE,cert1,620,Danio rerio,1:Experimental evidence at protein level,Ceramide transfer protein,1,0.999,4,6,6,6,5,1,5,1,5,1,220358128,67432792,
sp|Q5M9P8|ARL6_DANRE,Q5M9P8,ARL6_DANRE,arl6,186,Danio rerio,2:Experimental evidence at transcript level,ADP-ribosylation factor-like protein 6,1,0.999,8,11,11,11,9,2,9,2,9,2,409618816,38584248,
sp|Q5MD89|VGFR3_DANRE,Q5MD89,VGFR3_DANRE,flt4,1357,Danio rerio,2:Experimental evidence at transcript level,Vascular endothelial growth factor receptor 3,0.9389,0.9981,2,1,1,8,0,1,0,1,4,4,0,1739932.5,
sp|Q5MJ86|G3P2_DANRE,Q5MJ86,G3P2_DANRE,gapdh-2,335,Danio rerio,2:Experimental evidence at transcript level,Glyceraldehyde-3-phosphate dehydrogenase 2,1,0.999,32,413,413,444,204,209,204,209,218,226,63148634000,52065624000,
sp|Q5NDE5|PMGT2_DANRE,Q5NDE5,PMGT2_DANRE,pomgnt2,578,Danio rerio,2:Experimental evidence at transcript level,"Protein O-linked-mannose beta-1,4-N-acetylglucosaminyltransferase 2",0.981,0.9961,3,3,3,3,3,0,3,0,3,0,69423624,0,
sp|Q5PQY6|LONP2_DANRE,Q5PQY6,LONP2_DANRE,lonp2,840,Danio rerio,2:Experimental evidence at transcript level,"Lon protease homolog 2, peroxisomal",1,0.999,4,5,5,5,4,1,4,1,4,1,131632176,22499192,
sp|Q5PR34|CTR2_DANRE,Q5PR34,CTR2_DANRE,slc7a2,640,Danio rerio,2:Experimental evidence at transcript level,Cationic amino acid transporter 2,0.4428,0.9644,1,1,1,1,0,1,0,1,0,1,0,38046960,
sp|Q5PR67|EI3HB_DANRE,Q5PR67,EI3HB_DANRE,eif3hb,333,Danio rerio,2:Experimental evidence at transcript level,Eukaryotic translation initiation factor 3 subunit H-B,0.7501,0.9554,5,2,2,19,2,0,2,0,10,9,2787491840,0,
sp|Q5PR98|NDRG2_DANRE,Q5PR98,NDRG2_DANRE,ndrg2,368,Danio rerio,2:Experimental evidence at transcript level,Protein NDRG2,1,0.999,11,43,43,43,25,18,25,18,25,18,2869123580,2276286980,
sp|Q5PRA2|DHTK1_DANRE,Q5PRA2,DHTK1_DANRE,dhtkd1,920,Danio rerio,2:Experimental evidence at transcript level,2-oxoadipate dehydrogenase complex component E1,1,0.999,14,27,27,27,15,12,15,12,15,12,937017280,558411900,
sp|Q5PRD0|143BA_DANRE,Q5PRD0,143BA_DANRE,ywhaba,244,Danio rerio,2:Experimental evidence at transcript level,14-3-3 protein beta/alpha-A,1,0.999,29,528,186,528,262,266,95,91,262,266,157114270000,131877782000,
sp|Q5PRD4|KC1G1_DANRE,Q5PRD4,KC1G1_DANRE,csnk1g1,421,Danio rerio,2:Experimental evidence at transcript level,Casein kinase I isoform gamma-1,1,0.9976,6,12,12,12,5,7,5,7,5,7,459810240,300509728,
sp|Q5PYH5|DLG1L_DANRE,Q5PYH5,DLG1L_DANRE,dlg1l,827,Danio rerio,2:Experimental evidence at transcript level,Discs large homolog 1-like protein,1,0.999,21,62,17,62,37,25,11,6,37,25,4591798300,2901217790,
sp|Q5PYH6|DLG1_DANRE,Q5PYH6,DLG1_DANRE,dlg1,873,Danio rerio,2:Experimental evidence at transcript level,Disks large homolog 1,1,0.999,22,33,20,65,18,15,12,8,37,28,1285447040,896481020,
sp|Q5PYH7|DLG2_DANRE,Q5PYH7,DLG2_DANRE,dlg2,881,Danio rerio,2:Experimental evidence at transcript level,Disks large homolog 2,1,0.9986,11,10,10,30,7,3,7,3,17,13,290497408,152974944,
sp|Q5PZ43|XIRP1_DANRE,Q5PZ43,XIRP1_DANRE,xirp1,2297,Danio rerio,1:Experimental evidence at protein level,Xin actin-binding repeat-containing protein 1,1,0.999,4,9,9,9,5,4,5,4,5,4,273219968,223053872,
sp|Q5RG44|CRACD_DANRE,Q5RG44,CRACD_DANRE,crad,1079,Danio rerio,3:Protein inferred from homology,Capping protein inhibiting regulator of actin dynamics,1,0.9987,6,7,7,7,6,1,6,1,6,1,387794848,26499438,
sp|Q5RG82|NS1BA_DANRE,Q5RG82,NS1BA_DANRE,ivns1abpa,643,Danio rerio,2:Experimental evidence at transcript level,Influenza virus NS1A-binding protein homolog A,1,0.999,8,12,8,12,6,6,4,4,6,6,311135520,272307264,
sp|Q5RGE6|HSP7E_DANRE,Q5RGE6,HSP7E_DANRE,hspa14,504,Danio rerio,2:Experimental evidence at transcript level,Heat shock 70 kDa protein 14,1,0.999,14,25,25,25,16,9,16,9,16,9,886787580,245778720,
sp|Q5RGJ5|C19L1_DANRE,Q5RGJ5,C19L1_DANRE,cwf19l1,544,Danio rerio,2:Experimental evidence at transcript level,CWF19-like protein 1,1,0.999,13,25,25,25,15,10,15,10,15,10,1482622590,942106050,
sp|Q5RGJ6|WASC3_DANRE,Q5RGJ6,WASC3_DANRE,washc3,200,Danio rerio,2:Experimental evidence at transcript level,WASH complex subunit 3,0.9398,0.9981,1,1,1,1,1,0,1,0,1,0,29278620,0,
sp|Q5RGJ8|GNPTA_DANRE,Q5RGJ8,GNPTA_DANRE,gnptab,1219,Danio rerio,1:Experimental evidence at protein level,N-acetylglucosamine-1-phosphotransferase subunits alpha/beta,0.9991,0.9988,4,4,4,4,4,0,4,0,4,0,109448704,0,
sp|Q5RGL7|SMY2B_DANRE,Q5RGL7,SMY2B_DANRE,smyd2b,434,Danio rerio,1:Experimental evidence at protein level,N-lysine methyltransferase SMYD2-B,1,0.999,12,26,26,26,15,11,15,11,15,11,2130814850,592299010,
sp|Q5RGQ2|ANM8B_DANRE,Q5RGQ2,ANM8B_DANRE,prmt8b,419,Danio rerio,2:Experimental evidence at transcript level,Protein arginine N-methyltransferase 8-B,1,0.999,6,28,28,28,16,12,16,12,16,12,2843254530,1860327680,
sp|Q5RGT6|ANGE2_DANRE,Q5RGT6,ANGE2_DANRE,angel2,569,Danio rerio,2:Experimental evidence at transcript level,Protein angel homolog 2,1,0.9984,3,4,4,4,3,1,3,1,3,1,75499312,26741042,
sp|Q5RGU1|COQ8A_DANRE,Q5RGU1,COQ8A_DANRE,coq8a,619,Danio rerio,2:Experimental evidence at transcript level,"Atypical kinase COQ8A, mitochondrial",1,0.999,5,9,9,9,6,3,6,3,6,3,238495024,52308368,
sp|Q5RGV1|IMDH3_DANRE,Q5RGV1,IMDH3_DANRE,impdh1b,514,Danio rerio,2:Experimental evidence at transcript level,Inosine-5'-monophosphate dehydrogenase 1b,1,0.999,20,118,6,118,61,57,3,3,61,57,12837853200,9717162000,
sp|Q5RH01|CNDH2_DANRE,Q5RH01,CNDH2_DANRE,ncaph2,592,Danio rerio,2:Experimental evidence at transcript level,Condensin-2 complex subunit H2,0.9475,0.9984,1,1,1,1,1,0,1,0,1,0,20838892,0,
sp|Q5RH02|SCO2_DANRE,Q5RH02,SCO2_DANRE,sco2,279,Danio rerio,3:Protein inferred from homology,"Protein SCO2 homolog, mitochondrial",0.9858,0.9975,2,3,3,3,2,1,2,1,2,1,88576016,1512186.5,
sp|Q5RH51|XYLK_DANRE,Q5RH51,XYLK_DANRE,fam20b,409,Danio rerio,2:Experimental evidence at transcript level,Glycosaminoglycan xylosylkinase,0.9996,0.9983,2,4,4,4,2,2,2,2,2,2,31097940,45904368,
sp|Q5RH71|TSN33_DANRE,Q5RH71,TSN33_DANRE,tspan33,281,Danio rerio,2:Experimental evidence at transcript level,Tetraspanin-33,0.9985,0.9989,2,3,3,3,2,1,2,1,2,1,162762272,50772636,
sp|Q5RHQ8|LIN9_DANRE,Q5RHQ8,LIN9_DANRE,lin9,543,Danio rerio,3:Protein inferred from homology,Protein lin-9 homolog,0.9999,0.9989,3,3,3,3,2,1,2,1,2,1,76961480,27085204,
sp|Q5RHR0|PARP1_DANRE,Q5RHR0,PARP1_DANRE,parp1,1013,Danio rerio,2:Experimental evidence at transcript level,Poly [ADP-ribose] polymerase 1,1,0.999,38,97,97,97,56,41,56,41,56,41,5202230300,2611607300,
sp|Q5RHZ6|OSGEP_DANRE,Q5RHZ6,OSGEP_DANRE,osgep,335,Danio rerio,2:Experimental evidence at transcript level,tRNA N6-adenosine threonylcarbamoyltransferase,1,0.999,13,32,32,32,17,15,17,15,17,15,1073376900,761447360,
sp|Q5RI56|OPTN_DANRE,Q5RI56,OPTN_DANRE,optn,517,Danio rerio,2:Experimental evidence at transcript level,Optineurin,0.9679,0.9935,2,2,2,2,2,0,2,0,2,0,90270336,0,
sp|Q5RIC0|ELP3_DANRE,Q5RIC0,ELP3_DANRE,elp3,548,Danio rerio,2:Experimental evidence at transcript level,Elongator complex protein 3,0.9657,0.9948,2,3,3,3,2,1,2,1,2,1,4317978,77117152,
sp|Q5RID7|SNX17_DANRE,Q5RID7,SNX17_DANRE,snx17,473,Danio rerio,2:Experimental evidence at transcript level,Sorting nexin-17,1,0.999,5,6,6,6,5,1,5,1,5,1,255292512,62434000,
sp|Q5RIV4|ADAT2_DANRE,Q5RIV4,ADAT2_DANRE,adat2,214,Danio rerio,2:Experimental evidence at transcript level,tRNA-specific adenosine deaminase 2,0.6072,0.9814,1,1,1,1,1,0,1,0,1,0,4084270.5,0,
sp|Q5RIW8|MED23_DANRE,Q5RIW8,MED23_DANRE,med23,1376,Danio rerio,2:Experimental evidence at transcript level,Mediator of RNA polymerase II transcription subunit 23,0.9897,0.9899,2,2,2,2,2,0,2,0,2,0,44163748,0,
sp|Q5RJ20|AP2D_DANRE,Q5RJ20,AP2D_DANRE,tfap2d,450,Danio rerio,2:Experimental evidence at transcript level,Transcription factor AP-2-delta,0.927,0.998,1,1,0,1,1,0,0,0,1,0,56141284,0,
sp|Q5RKN4|GLYR1_DANRE,Q5RKN4,GLYR1_DANRE,glyr1,462,Danio rerio,2:Experimental evidence at transcript level,Cytokine-like nuclear factor N-PAC,1,0.999,17,71,71,71,41,30,41,30,41,30,4546262000,3150588930,
sp|Q5RZ65|AGR2_DANRE,Q5RZ65,AGR2_DANRE,agr2,171,Danio rerio,2:Experimental evidence at transcript level,Anterior gradient protein 2 homolog,1,0.999,8,42,42,42,20,22,20,22,20,22,1774016380,1668590460,
sp|Q5SNX7|GALC_DANRE,Q5SNX7,GALC_DANRE,galc,660,Danio rerio,2:Experimental evidence at transcript level,Galactocerebrosidase,1,0.999,23,60,60,60,32,28,32,28,32,28,4208939780,2014980860,
sp|Q5SP67|WDR26_DANRE,Q5SP67,WDR26_DANRE,wdr26,576,Danio rerio,1:Experimental evidence at protein level,WD repeat-containing protein 26,1,0.999,11,26,26,26,18,8,18,8,18,8,751734020,436379040,
sp|Q5SP90|PP4R3_DANRE,Q5SP90,PP4R3_DANRE,smek1,818,Danio rerio,1:Experimental evidence at protein level,Serine/threonine-protein phosphatase 4 regulatory subunit 3,1,0.9987,16,30,30,30,13,17,13,17,13,17,869050370,3811215870,
sp|Q5SPC5|OTOF_DANRE,Q5SPC5,OTOF_DANRE,otof,1992,Danio rerio,3:Protein inferred from homology,Otoferlin,1,0.9988,4,5,5,5,4,1,4,1,4,1,948868540,24823420,
sp|Q5SPD7|P5CR3_DANRE,Q5SPD7,P5CR3_DANRE,pycr3,288,Danio rerio,2:Experimental evidence at transcript level,Pyrroline-5-carboxylate reductase 3,1,0.999,15,44,44,44,27,17,27,17,27,17,2571659010,1539490820,
sp|Q5SPH9|RT10_DANRE,Q5SPH9,RT10_DANRE,mrps10,187,Danio rerio,3:Protein inferred from homology,Small ribosomal subunit protein uS10m,0.6156,0.982,2,2,2,2,0,2,0,2,0,2,0,216531440,
sp|Q5SPJ8|XPOT_DANRE,Q5SPJ8,XPOT_DANRE,xpot,961,Danio rerio,3:Protein inferred from homology,Exportin-T,1,0.9989,5,8,8,8,5,3,5,3,5,3,89242512,45191536,
sp|Q5SPP0|CLVS2_DANRE,Q5SPP0,CLVS2_DANRE,clvs2,329,Danio rerio,2:Experimental evidence at transcript level,Clavesin-2,1,0.999,4,7,7,7,4,3,4,3,4,3,157522528,108082368,
sp|Q5SQE2|STB5L_DANRE,Q5SQE2,STB5L_DANRE,stxbp5l,1159,Danio rerio,3:Protein inferred from homology,Syntaxin-binding protein 5-like,1,0.999,7,15,15,15,10,5,10,5,10,5,572997440,151485152,
sp|Q5TYQ1|ZYG11_DANRE,Q5TYQ1,ZYG11_DANRE,zyg11,746,Danio rerio,2:Experimental evidence at transcript level,Protein zyg-11 homolog,0.7425,0.9852,2,2,2,2,2,0,2,0,2,0,1332687.2,0,
sp|Q5TYQ3|COA7_DANRE,Q5TYQ3,COA7_DANRE,coa7,229,Danio rerio,2:Experimental evidence at transcript level,Cytochrome c oxidase assembly factor 7,1,0.999,11,25,25,25,12,13,12,13,12,13,1623009150,1034832260,
sp|Q5TYQ8|ZC3HE_DANRE,Q5TYQ8,ZC3HE_DANRE,zc3h14,669,Danio rerio,2:Experimental evidence at transcript level,Zinc finger CCCH domain-containing protein 14,0.955,0.9986,1,1,1,1,1,0,1,0,1,0,36770052,0,
sp|Q5TYS5|SCRN2_DANRE,Q5TYS5,SCRN2_DANRE,scrn2,415,Danio rerio,2:Experimental evidence at transcript level,Secernin-2,1,0.999,4,7,7,7,4,3,4,3,4,3,257867680,109122104,
sp|Q5TYV0|EMC7_DANRE,Q5TYV0,EMC7_DANRE,emc7,237,Danio rerio,2:Experimental evidence at transcript level,Endoplasmic reticulum membrane protein complex subunit 7,1,0.9988,5,12,12,12,7,5,7,5,7,5,519815776,173007024,
sp|Q5TYV4|SPE39_DANRE,Q5TYV4,SPE39_DANRE,vipas39,483,Danio rerio,2:Experimental evidence at transcript level,Spermatogenesis-defective protein 39 homolog,0.9994,0.999,3,4,4,4,3,1,3,1,3,1,94287984,22686988,
sp|Q5TYW4|NBAS_DANRE,Q5TYW4,NBAS_DANRE,nbas,2372,Danio rerio,2:Experimental evidence at transcript level,NBAS subunit of NRZ tethering complex,0.9686,0.9951,2,2,2,2,0,2,0,2,0,2,0,29212178,
sp|Q5TYW6|RSPH9_DANRE,Q5TYW6,RSPH9_DANRE,rsph9,277,Danio rerio,1:Experimental evidence at protein level,Radial spoke head protein 9 homolog,0.8511,0.9949,1,1,1,1,1,0,1,0,1,0,0,0,
sp|Q5TZ66|SN25A_DANRE,Q5TZ66,SN25A_DANRE,snap25a,204,Danio rerio,2:Experimental evidence at transcript level,Synaptosomal-associated protein 25-A,1,0.999,11,34,12,34,17,17,5,7,17,17,1589419780,1173960060,
sp|Q5TZ80|HOOK1_DANRE,Q5TZ80,HOOK1_DANRE,hook1,715,Danio rerio,2:Experimental evidence at transcript level,Protein Hook homolog 1,0.9236,0.9976,2,2,2,2,1,1,1,1,1,1,42688012,859213.3,
sp|Q5U379|SNF5_DANRE,Q5U379,SNF5_DANRE,smarcb1a,373,Danio rerio,2:Experimental evidence at transcript level,SWI/SNF-related matrix-associated actin-dependent regulator of chromatin subfamily B member 1-A,1,0.999,8,13,13,13,8,5,8,5,8,5,556420800,272299040,
sp|Q5U385|TBPL1_DANRE,Q5U385,TBPL1_DANRE,tbpl1,186,Danio rerio,2:Experimental evidence at transcript level,TATA box-binding protein-like 1,0.7919,0.9923,1,1,1,1,1,0,1,0,1,0,27397788,0,
sp|Q5U3A7|OPA1_DANRE,Q5U3A7,OPA1_DANRE,opa1,966,Danio rerio,2:Experimental evidence at transcript level,"Dynamin-like GTPase OPA1, mitochondrial",1,0.999,22,42,42,42,21,21,21,21,21,21,1204967300,1149633920,
sp|Q5U3F2|SLU7_DANRE,Q5U3F2,SLU7_DANRE,slu7,571,Danio rerio,2:Experimental evidence at transcript level,Pre-mRNA-splicing factor SLU7,0.7788,0.9634,2,2,2,2,1,1,1,1,1,1,0,28262614,
sp|Q5U3F8|3HAO_DANRE,Q5U3F8,3HAO_DANRE,haao,287,Danio rerio,2:Experimental evidence at transcript level,"3-hydroxyanthranilate 3,4-dioxygenase",1,0.999,8,30,30,30,18,12,18,12,18,12,1643038850,1021433660,
sp|Q5U3I0|SAM5B_DANRE,Q5U3I0,SAM5B_DANRE,samm50b,469,Danio rerio,2:Experimental evidence at transcript level,Sorting and assembly machinery component 50 homolog B,1,0.999,16,22,22,28,14,8,14,8,18,10,903704770,291547488,
sp|Q5U3N0|PKHA8_DANRE,Q5U3N0,PKHA8_DANRE,plekha8,549,Danio rerio,2:Experimental evidence at transcript level,Pleckstrin homology domain-containing family A member 8,0.9972,0.996,4,5,5,5,4,1,4,1,4,1,87340048,45301564,
sp|Q5U3P0|PCID2_DANRE,Q5U3P0,PCID2_DANRE,pcid2,399,Danio rerio,2:Experimental evidence at transcript level,PCI domain-containing protein 2,0.9998,0.9987,3,5,5,5,3,2,3,2,3,2,134200056,54497412,
sp|Q5U3Q6|CIP4_DANRE,Q5U3Q6,CIP4_DANRE,trip10,542,Danio rerio,2:Experimental evidence at transcript level,Cdc42-interacting protein 4 homolog,0.9926,0.9974,3,2,2,7,2,0,2,0,5,2,53236128,0,
sp|Q5U3S1|KATL1_DANRE,Q5U3S1,KATL1_DANRE,katnal1,488,Danio rerio,2:Experimental evidence at transcript level,Katanin p60 ATPase-containing subunit A-like 1,0.874,0.9649,2,5,3,5,2,3,1,2,2,3,81212848,64101448,
sp|Q5U3T0|MGT4C_DANRE,Q5U3T0,MGT4C_DANRE,mgat4c,454,Danio rerio,2:Experimental evidence at transcript level,"Alpha-1,3-mannosyl-glycoprotein 4-beta-N-acetylglucosaminyltransferase C",1,0.999,3,4,4,4,3,1,3,1,3,1,1725179390,810415490,
sp|Q5U3U0|PHYD1_DANRE,Q5U3U0,PHYD1_DANRE,phyhd1,291,Danio rerio,2:Experimental evidence at transcript level,Phytanoyl-CoA dioxygenase domain-containing protein 1,1,0.999,11,39,39,39,22,17,22,17,22,17,2036447620,1065826180,
sp|Q5U3U3|CPT2_DANRE,Q5U3U3,CPT2_DANRE,cpt2,669,Danio rerio,2:Experimental evidence at transcript level,"Carnitine O-palmitoyltransferase 2, mitochondrial",1,0.999,35,115,115,115,61,54,61,54,61,54,8540013100,4841671700,
sp|Q5U3U4|CDAC1_DANRE,Q5U3U4,CDAC1_DANRE,cdadc1,471,Danio rerio,2:Experimental evidence at transcript level,Cytidine and dCMP deaminase domain-containing protein 1,0.9985,0.999,2,2,2,2,2,0,2,0,2,0,48376016,0,
sp|Q5U3V9|SNF8_DANRE,Q5U3V9,SNF8_DANRE,snf8,258,Danio rerio,2:Experimental evidence at transcript level,Vacuolar-sorting protein SNF8,0.9999,0.9988,2,4,4,4,3,1,3,1,3,1,65499712,26091202,
sp|Q5U3W0|CPPED_DANRE,Q5U3W0,CPPED_DANRE,cpped1,309,Danio rerio,2:Experimental evidence at transcript level,Serine/threonine-protein phosphatase CPPED1,1,0.999,7,22,22,22,15,7,15,7,15,7,606508100,392482240,
sp|Q5U403|MVD1_DANRE,Q5U403,MVD1_DANRE,mvd,400,Danio rerio,2:Experimental evidence at transcript level,Diphosphomevalonate decarboxylase,1,0.999,11,22,22,22,12,10,12,10,12,10,764745470,389021472,
sp|Q5W7F1|ASAH2_DANRE,Q5W7F1,ASAH2_DANRE,asah2,743,Danio rerio,1:Experimental evidence at protein level,Neutral ceramidase,1,0.999,8,10,10,10,6,4,6,4,6,4,289521088,139862816,
sp|Q5W8I7|VGL2B_DANRE,Q5W8I7,VGL2B_DANRE,slc17a6a,587,Danio rerio,2:Experimental evidence at transcript level,Vesicular glutamate transporter 2.2,0.9987,0.9977,4,8,6,8,5,3,4,2,5,3,518482944,262181376,
sp|Q5W8I8|VGL2A_DANRE,Q5W8I8,VGL2A_DANRE,slc17a6b,584,Danio rerio,2:Experimental evidence at transcript level,Vesicular glutamate transporter 2.1,0.5888,0.9684,2,1,1,3,1,0,1,0,2,1,21911436,0,
sp|Q5XFY4|BCL7A_DANRE,Q5XFY4,BCL7A_DANRE,bcl7a,201,Danio rerio,2:Experimental evidence at transcript level,B-cell CLL/lymphoma 7 protein family member A,1,0.999,4,8,8,8,5,3,5,3,5,3,490654656,295038912,
sp|Q5XIY6|VTC1B_DANRE,Q5XIY6,VTC1B_DANRE,atp6v1c1b,381,Danio rerio,2:Experimental evidence at transcript level,V-type proton ATPase subunit C 1-B,1,0.999,26,48,48,71,27,21,27,21,42,29,2767921410,1744630910,
sp|Q5XIZ6|GPD1L_DANRE,Q5XIZ6,GPD1L_DANRE,gpd1l,351,Danio rerio,2:Experimental evidence at transcript level,Glycerol-3-phosphate dehydrogenase 1-like protein,1,0.999,25,99,99,99,50,49,50,49,50,49,7526942700,5193373700,
sp|Q5XJ10|G3P_DANRE,Q5XJ10,G3P_DANRE,gapdh,333,Danio rerio,2:Experimental evidence at transcript level,Glyceraldehyde-3-phosphate dehydrogenase,1,0.999,29,581,550,581,311,270,297,253,311,270,145808294000,98518311000,
sp|Q5XJ34|KC15L_DANRE,Q5XJ34,KC15L_DANRE,kctd15l,257,Danio rerio,1:Experimental evidence at protein level,BTB/POZ domain-containing protein kctd15-like,1,0.999,12,10,10,20,5,5,5,5,12,8,353044480,188750448,
sp|Q5XJ36|PARK7_DANRE,Q5XJ36,PARK7_DANRE,park7,189,Danio rerio,2:Experimental evidence at transcript level,Parkinson disease protein 7 homolog,1,0.999,18,187,187,187,98,89,98,89,98,89,27011371000,18206273500,
sp|Q5XJ54|GLRX3_DANRE,Q5XJ54,GLRX3_DANRE,glrx3,326,Danio rerio,2:Experimental evidence at transcript level,Glutaredoxin 3,1,0.999,18,123,123,123,62,61,62,61,62,61,10043941900,6928452600,
sp|Q5XJ57|TRMB_DANRE,Q5XJ57,TRMB_DANRE,mettl1,241,Danio rerio,2:Experimental evidence at transcript level,tRNA (guanine-N(7)-)-methyltransferase,1,0.9989,5,11,11,11,7,4,7,4,7,4,497159360,102866736,
sp|Q5XJ97|C1D_DANRE,Q5XJ97,C1D_DANRE,c1d,148,Danio rerio,2:Experimental evidence at transcript level,Nuclear nucleic acid-binding protein C1D,0.9613,0.9814,3,3,3,3,3,0,3,0,3,0,59868048,0,
sp|Q5XJA0|TYDP2_DANRE,Q5XJA0,TYDP2_DANRE,tdp2,369,Danio rerio,1:Experimental evidence at protein level,Tyrosyl-DNA phosphodiesterase 2,0.8666,0.9955,1,3,3,3,2,1,2,1,2,1,15290573,42942932,
sp|Q5XJA3|PRRC1_DANRE,Q5XJA3,PRRC1_DANRE,prrc1,435,Danio rerio,1:Experimental evidence at protein level,Protein PRRC1,1,0.999,12,41,41,41,22,19,22,19,22,19,3072195580,1960358270,
sp|Q5XJN2|GILT_DANRE,Q5XJN2,GILT_DANRE,ifi30,255,Danio rerio,1:Experimental evidence at protein level,Gamma-interferon-inducible lysosomal thiol reductase,1,0.999,6,36,36,36,23,13,23,13,23,13,3145517310,1514832380,
sp|Q5XJP1|EIPR1_DANRE,Q5XJP1,EIPR1_DANRE,eipr1,387,Danio rerio,2:Experimental evidence at transcript level,EARP-interacting protein homolog,1,0.999,10,22,22,22,15,7,15,7,15,7,848156100,457576640,
sp|Q5XJQ5|EXOS9_DANRE,Q5XJQ5,EXOS9_DANRE,exosc9,393,Danio rerio,2:Experimental evidence at transcript level,Exosome complex component RRP45,1,0.999,11,24,24,24,15,9,15,9,15,9,881125180,485727680,
sp|Q5XJS5|THOC6_DANRE,Q5XJS5,THOC6_DANRE,thoc6,323,Danio rerio,2:Experimental evidence at transcript level,THO complex subunit 6 homolog,1,0.999,9,29,29,29,17,12,17,12,17,12,1497969280,944942780,
sp|Q5XJX1|SEGN_DANRE,Q5XJX1,SEGN_DANRE,scgn,272,Danio rerio,1:Experimental evidence at protein level,Secretagogin,1,0.999,17,34,34,34,22,12,22,12,22,12,1456071420,839285380,
sp|Q5XTN8|CRGNA_DANRE,Q5XTN8,CRGNA_DANRE,crygna,183,Danio rerio,2:Experimental evidence at transcript level,Gamma-crystallin N-A,0.9876,0.9952,6,6,6,18,2,4,2,4,8,10,442627520,349360608,
sp|Q5XXA7|HDGR2_DANRE,Q5XXA7,HDGR2_DANRE,hdgfl2,662,Danio rerio,2:Experimental evidence at transcript level,Hepatoma-derived growth factor-related protein 2,0.718,0.9886,1,3,3,3,1,2,1,2,1,2,98249304,53872640,
sp|Q642H3|SEP8A_DANRE,Q642H3,SEP8A_DANRE,sept8a,420,Danio rerio,2:Experimental evidence at transcript level,Septin-8-A,1,0.999,21,131,37,131,72,59,23,14,72,59,10130820100,7720026100,
sp|Q642H7|RIC8A_DANRE,Q642H7,RIC8A_DANRE,ric8a,548,Danio rerio,2:Experimental evidence at transcript level,Synembryn-A,0.9987,0.9965,4,5,5,5,4,1,4,1,4,1,182018256,76349096,
sp|Q642H9|RS4X_DANRE,Q642H9,RS4X_DANRE,rps4x,263,Danio rerio,1:Experimental evidence at protein level,Small ribosomal subunit protein eS4,1,0.999,23,93,93,93,28,65,28,65,28,65,3768214780,8632623100,
sp|Q642J5|RFOX1_DANRE,Q642J5,RFOX1_DANRE,rbfox1,373,Danio rerio,2:Experimental evidence at transcript level,RNA binding protein fox-1 homolog 1,1,0.999,11,46,11,46,24,22,8,3,24,22,4770439700,3223491580,
sp|Q642M9|DHDH_DANRE,Q642M9,DHDH_DANRE,dhdh,334,Danio rerio,2:Experimental evidence at transcript level,"Trans-1,2-dihydrobenzene-1,2-diol dehydrogenase",1,0.999,28,92,92,92,55,37,55,37,55,37,5587446800,2939717890,
sp|Q66HT8|ADPRS_DANRE,Q66HT8,ADPRS_DANRE,adprs,370,Danio rerio,2:Experimental evidence at transcript level,ADP-ribosylhydrolase ARH3,1,0.999,12,26,26,26,18,8,18,8,18,8,1546276350,615783040,
sp|Q66HV4|COPB_DANRE,Q66HV4,COPB_DANRE,copb1,953,Danio rerio,2:Experimental evidence at transcript level,Coatomer subunit beta,1,0.999,34,99,99,99,58,41,58,41,58,41,5384029700,3553980930,
sp|Q66HV9|LIG1B_DANRE,Q66HV9,LIG1B_DANRE,lingo1b,622,Danio rerio,1:Experimental evidence at protein level,Leucine-rich repeat and immunoglobulin-like domain-containing nogo receptor-interacting protein 1-B,0.9999,0.9984,3,5,5,5,4,1,4,1,4,1,55567552,15993808,
sp|Q66HW4|GLMP_DANRE,Q66HW4,GLMP_DANRE,glmp,407,Danio rerio,2:Experimental evidence at transcript level,Glycosylated lysosomal membrane protein,0.9987,0.999,2,3,3,3,2,1,2,1,2,1,60660464,58456048,
sp|Q66HX8|GDAP2_DANRE,Q66HX8,GDAP2_DANRE,gdap2,504,Danio rerio,2:Experimental evidence at transcript level,Ganglioside-induced differentiation-associated protein 2,0.6511,0.9751,2,6,6,6,4,2,4,2,4,2,380164416,111338368,
sp|Q66HY7|IF4E3_DANRE,Q66HY7,IF4E3_DANRE,eif4e3,224,Danio rerio,2:Experimental evidence at transcript level,Eukaryotic translation initiation factor 4E type 3,1,0.9989,4,8,8,8,6,2,6,2,6,2,316559616,146496160,
sp|Q66HY8|PDXD1_DANRE,Q66HY8,PDXD1_DANRE,pdxdc1,751,Danio rerio,2:Experimental evidence at transcript level,Pyridoxal-dependent decarboxylase domain-containing protein 1,0.9728,0.9989,2,5,5,5,3,2,3,2,3,2,160777280,163652592,
sp|Q66HZ2|RIMKB_DANRE,Q66HZ2,RIMKB_DANRE,rimklb,405,Danio rerio,2:Experimental evidence at transcript level,Beta-citrylglutamate synthase B,0.9726,0.9815,3,4,4,4,3,1,3,1,3,1,99593864,39478248,
sp|Q66I08|OSTA_DANRE,Q66I08,OSTA_DANRE,slc51a,326,Danio rerio,2:Experimental evidence at transcript level,Organic solute transporter subunit alpha,0.7742,0.9915,1,1,1,1,0,1,0,1,0,1,0,0,
sp|Q66I12|CCD47_DANRE,Q66I12,CCD47_DANRE,ccdc47,486,Danio rerio,2:Experimental evidence at transcript level,PAT complex subunit CCDC47,1,0.999,7,18,18,18,11,7,11,7,11,7,429795392,292323808,
sp|Q66I14|SPS3_DANRE,Q66I14,SPS3_DANRE,sephs3,447,Danio rerio,2:Experimental evidence at transcript level,"Selenide, water dikinase 3",1,0.999,9,50,50,50,29,21,29,21,29,21,5005635600,1658470910,
sp|Q66I21|AL8A1_DANRE,Q66I21,AL8A1_DANRE,aldh8a1,487,Danio rerio,2:Experimental evidence at transcript level,2-aminomuconic semialdehyde dehydrogenase,1,0.999,20,72,72,72,32,40,32,40,32,40,3764974850,4296050700,
sp|Q66I24|ASSY_DANRE,Q66I24,ASSY_DANRE,ass1,414,Danio rerio,2:Experimental evidence at transcript level,Argininosuccinate synthase,1,0.999,19,40,40,40,20,20,20,20,20,20,1477281540,1173460350,
sp|Q66I42|MOESA_DANRE,Q66I42,MOESA_DANRE,msna,579,Danio rerio,1:Experimental evidence at protein level,Moesin a,1,0.999,48,210,210,210,109,101,109,101,109,101,18756536300,14575245300,
sp|Q66I59|ASPDH_DANRE,Q66I59,ASPDH_DANRE,aspdh,276,Danio rerio,2:Experimental evidence at transcript level,Aspartate dehydrogenase domain-containing protein,1,0.999,5,6,6,6,5,1,5,1,5,1,164338144,17330156,
sp|Q66I61|STEEP_DANRE,Q66I61,STEEP_DANRE,steep1,224,Danio rerio,2:Experimental evidence at transcript level,STING ER exit protein,1,0.999,4,9,9,9,5,4,5,4,5,4,359882816,215651744,
sp|Q66I71|UCK1_DANRE,Q66I71,UCK1_DANRE,uck1,277,Danio rerio,2:Experimental evidence at transcript level,Uridine-cytidine kinase 1,0.7393,0.9898,1,1,0,1,1,0,0,0,1,0,22953936,0,"sp|Q7SYM0|UCK2A_DANRE, sp|Q7ZV79|UCK2B_DANRE"
sp|Q66I73|MLRSB_DANRE,Q66I73,MLRSB_DANRE,mylpfb,170,Danio rerio,2:Experimental evidence at transcript level,"Myosin regulatory light chain 2, skeletal muscle isoform B",1,0.999,23,249,249,1275,131,118,131,118,648,627,99449094000,91349811000,
sp|Q66I75|MTNB_DANRE,Q66I75,MTNB_DANRE,apip,241,Danio rerio,2:Experimental evidence at transcript level,Methylthioribulose-1-phosphate dehydratase,1,0.999,18,80,80,80,39,41,39,41,39,41,4818918400,3186341380,
sp|Q66IB8|CB076_DANRE,Q66IB8,CB076_DANRE,zgc:101851,126,Danio rerio,2:Experimental evidence at transcript level,UPF0538 protein C2orf76 homolog,0.9999,0.999,3,5,5,5,4,1,4,1,4,1,91890568,3444531,
sp|Q66L49|SCMC1_DANRE,Q66L49,SCMC1_DANRE,slc25a24,477,Danio rerio,2:Experimental evidence at transcript level,Mitochondrial adenyl nucleotide antiporter SLC25A24,1,0.999,17,70,69,70,40,30,39,30,40,30,5984457200,3921833470,
sp|Q66L58|VAC14_DANRE,Q66L58,VAC14_DANRE,vac14,771,Danio rerio,2:Experimental evidence at transcript level,Protein VAC14 homolog,1,0.999,10,15,15,15,12,3,12,3,12,3,662490620,138353456,
sp|Q68EH7|HXC8A_DANRE,Q68EH7,HXC8A_DANRE,hoxc8a,250,Danio rerio,2:Experimental evidence at transcript level,Homeobox protein Hox-C8a,0.6701,0.9858,1,1,0,1,0,1,0,0,0,1,0,18242812,"sp|Q8AWZ0|HXB8A_DANRE, sp|Q8JH55|HXB8B_DANRE"
sp|Q68EH8|FAD1_DANRE,Q68EH8,FAD1_DANRE,flad1,497,Danio rerio,2:Experimental evidence at transcript level,FAD synthase,0.9999,0.999,3,5,5,5,3,2,3,2,3,2,67627088,63238484,
sp|Q68EI0|WDR18_DANRE,Q68EI0,WDR18_DANRE,wdr18,431,Danio rerio,2:Experimental evidence at transcript level,WD repeat-containing protein 18,1,0.999,5,10,10,10,7,3,7,3,7,3,342890432,111893152,
sp|Q68EK7|RAB4B_DANRE,Q68EK7,RAB4B_DANRE,rab4b,213,Danio rerio,2:Experimental evidence at transcript level,Ras-related protein Rab-4B,1,0.9989,8,12,12,59,7,5,7,5,28,31,477657568,206487168,
sp|Q68EL2|DTD2_DANRE,Q68EL2,DTD2_DANRE,dtd2,160,Danio rerio,1:Experimental evidence at protein level,D-aminoacyl-tRNA deacylase 2,1,0.999,9,16,16,16,12,4,12,4,12,4,455532736,178095072,
sp|Q68FN7|DHSDB_DANRE,Q68FN7,DHSDB_DANRE,sdhdb,158,Danio rerio,2:Experimental evidence at transcript level,"Succinate dehydrogenase [ubiquinone] cytochrome b small subunit B, mitochondrial",0.9994,0.9949,2,9,9,9,5,4,5,4,5,4,269771456,414552256,
sp|Q68SP4|CADH5_DANRE,Q68SP4,CADH5_DANRE,cdh5,767,Danio rerio,1:Experimental evidence at protein level,Cadherin-5,1,0.999,8,9,9,9,7,2,7,2,7,2,331655488,43358032,
sp|Q696W0|SPEG_DANRE,Q696W0,SPEG_DANRE,speg,2995,Danio rerio,2:Experimental evidence at transcript level,Striated muscle preferentially expressed protein kinase,1,0.988,2,4,4,4,2,2,2,2,2,2,476831520,274701088,
sp|Q6AXJ2|EI3HA_DANRE,Q6AXJ2,EI3HA_DANRE,eif3ha,335,Danio rerio,2:Experimental evidence at transcript level,Eukaryotic translation initiation factor 3 subunit H-A,1,0.999,9,56,39,56,29,27,21,18,29,27,5743738400,3774442500,
sp|Q6AXK4|BABA1_DANRE,Q6AXK4,BABA1_DANRE,babam1,370,Danio rerio,1:Experimental evidence at protein level,BRISC and BRCA1-A complex member 1,1,0.999,7,14,14,14,6,8,6,8,6,8,454519616,350716224,
sp|Q6AXL4|NCLDB_DANRE,Q6AXL4,NCLDB_DANRE,ncaldb,192,Danio rerio,2:Experimental evidence at transcript level,Neurocalcin-delta B,1,0.999,10,23,23,88,12,11,12,11,48,40,1094108930,1105077380,
sp|Q6AZA0|THIL_DANRE,Q6AZA0,THIL_DANRE,acat1,420,Danio rerio,2:Experimental evidence at transcript level,"Acetyl-CoA acetyltransferase, mitochondrial",1,0.999,28,184,184,184,103,81,103,81,103,81,16826113000,8413639700,
sp|Q6AZB3|CPIN1_DANRE,Q6AZB3,CPIN1_DANRE,ciapin1,311,Danio rerio,2:Experimental evidence at transcript level,Anamorsin,1,0.999,11,27,27,27,14,13,14,13,14,13,1318600960,1059801860,
sp|Q6AZW2|A1A1A_DANRE,Q6AZW2,A1A1A_DANRE,akr1a1a,324,Danio rerio,2:Experimental evidence at transcript level,Aldo-keto reductase family 1 member A1-A,1,0.999,13,27,27,27,15,12,15,12,15,12,2851921660,989663420,
sp|Q6BEA0|PLXA4_DANRE,Q6BEA0,PLXA4_DANRE,plxna4,1903,Danio rerio,2:Experimental evidence at transcript level,Plexin-A4,1,0.999,33,37,37,52,18,19,18,19,27,25,1029181250,639944450,
sp|Q6DBQ8|CPTP_DANRE,Q6DBQ8,CPTP_DANRE,cptp,211,Danio rerio,2:Experimental evidence at transcript level,Ceramide-1-phosphate transfer protein,0.5213,0.9738,1,1,1,1,1,0,1,0,1,0,38610776,0,
sp|Q6DBR4|TIPIN_DANRE,Q6DBR4,TIPIN_DANRE,tipin,294,Danio rerio,2:Experimental evidence at transcript level,TIMELESS-interacting protein,0.5535,0.9769,2,2,2,2,0,2,0,2,0,2,0,12013689,
sp|Q6DBR9|KXDL1_DANRE,Q6DBR9,KXDL1_DANRE,kxd1,182,Danio rerio,2:Experimental evidence at transcript level,KxDL motif-containing protein 1,0.5205,0.9737,1,2,2,2,1,1,1,1,1,1,17724238,17091776,
sp|Q6DBT3|TXD17_DANRE,Q6DBT3,TXD17_DANRE,txndc17,123,Danio rerio,2:Experimental evidence at transcript level,Thioredoxin domain-containing protein 17,1,0.999,12,65,65,65,34,31,34,31,34,31,12153417700,5962983900,
sp|Q6DBU5|GMPPB_DANRE,Q6DBU5,GMPPB_DANRE,gmppb,360,Danio rerio,1:Experimental evidence at protein level,Mannose-1-phosphate guanylyltransferase catalytic subunit beta,1,0.999,21,67,67,67,35,32,35,32,35,32,4869587500,3403910400,
sp|Q6DBU8|LIPH_DANRE,Q6DBU8,LIPH_DANRE,liph,454,Danio rerio,2:Experimental evidence at transcript level,Lipase member H,0.9998,0.9988,3,5,5,5,3,2,3,2,3,2,82309984,18061370,
sp|Q6DBW9|C99L2_DANRE,Q6DBW9,C99L2_DANRE,cd99l2,252,Danio rerio,2:Experimental evidence at transcript level,CD99 antigen-like protein 2,1,0.999,3,8,8,8,5,3,5,3,5,3,369414816,323943552,
sp|Q6DBX1|MED20_DANRE,Q6DBX1,MED20_DANRE,med20,212,Danio rerio,2:Experimental evidence at transcript level,Mediator of RNA polymerase II transcription subunit 20,1,0.999,3,5,5,5,2,3,2,3,2,3,61037288,99866176,
sp|Q6DBY0|NUP85_DANRE,Q6DBY0,NUP85_DANRE,nup85,649,Danio rerio,2:Experimental evidence at transcript level,Nuclear pore complex protein Nup85,1,0.999,7,13,13,13,8,5,8,5,8,5,531122304,127097560,
sp|Q6DBY2|NAA50_DANRE,Q6DBY2,NAA50_DANRE,naa50,168,Danio rerio,1:Experimental evidence at protein level,N-alpha-acetyltransferase 50,1,0.999,11,27,27,27,13,14,13,14,13,14,3060489220,1733269250,
sp|Q6DBY5|UEVLD_DANRE,Q6DBY5,UEVLD_DANRE,uevld,471,Danio rerio,2:Experimental evidence at transcript level,Ubiquitin-conjugating enzyme E2 variant 3,1,0.999,6,9,9,9,6,3,6,3,6,3,406175616,2024631040,
sp|Q6DC02|KCD15_DANRE,Q6DC02,KCD15_DANRE,kctd15,257,Danio rerio,1:Experimental evidence at protein level,BTB/POZ domain-containing protein kctd15,1,0.999,12,22,12,22,14,8,7,5,14,8,727743040,431843904,
sp|Q6DC04|CARM1_DANRE,Q6DC04,CARM1_DANRE,carm1,588,Danio rerio,2:Experimental evidence at transcript level,Histone-arginine methyltransferase CARM1,1,0.999,21,70,70,70,43,27,43,27,43,27,4923735600,3107507710,
sp|Q6DC17|MZT2_DANRE,Q6DC17,MZT2_DANRE,mzt2,153,Danio rerio,2:Experimental evidence at transcript level,Mitotic-spindle organizing protein 2,0.9585,0.9987,2,5,5,5,3,2,3,2,3,2,212083552,173872544,
sp|Q6DC37|HNMT_DANRE,Q6DC37,HNMT_DANRE,hnmt,292,Danio rerio,2:Experimental evidence at transcript level,Histamine N-methyltransferase,1,0.999,6,10,10,10,5,5,5,5,5,5,701236860,562294400,
sp|Q6DC39|DESI2_DANRE,Q6DC39,DESI2_DANRE,desi2,196,Danio rerio,2:Experimental evidence at transcript level,Deubiquitinase DESI2,0.8733,0.9958,1,2,2,2,1,1,1,1,1,1,75570256,52344240,
sp|Q6DC53|CTU2_DANRE,Q6DC53,CTU2_DANRE,ctu2,501,Danio rerio,2:Experimental evidence at transcript level,Cytoplasmic tRNA 2-thiolation protein 2,0.8371,0.9745,2,2,2,2,0,2,0,2,0,2,0,308821.3,
sp|Q6DC93|PEF1_DANRE,Q6DC93,PEF1_DANRE,pef1,270,Danio rerio,2:Experimental evidence at transcript level,Peflin,1,0.999,2,5,5,5,4,1,4,1,4,1,137254528,76821976,
sp|Q6DEG4|LTOR2_DANRE,Q6DEG4,LTOR2_DANRE,lamtor2,125,Danio rerio,2:Experimental evidence at transcript level,Ragulator complex protein LAMTOR2,1,0.999,6,26,26,26,13,13,13,13,13,13,945378560,742738110,
sp|Q6DEH3|KC2D1_DANRE,Q6DEH3,KC2D1_DANRE,camk2d1,491,Danio rerio,2:Experimental evidence at transcript level,Calcium/calmodulin-dependent protein kinase type II delta 1 chain,1,0.999,32,231,89,231,120,111,46,43,120,111,25903749100,18847492100,
sp|Q6DEI8|MIA40_DANRE,Q6DEI8,MIA40_DANRE,chchd4,146,Danio rerio,2:Experimental evidence at transcript level,Mitochondrial intermembrane space import and assembly protein 40,1,0.999,3,12,12,12,7,5,7,5,7,5,1354934400,1084272000,
sp|Q6DEJ5|AASD1_DANRE,Q6DEJ5,AASD1_DANRE,aarsd1,412,Danio rerio,2:Experimental evidence at transcript level,Alanyl-tRNA editing protein Aarsd1,1,0.9988,9,16,16,16,9,7,9,7,9,7,681050940,335078528,
sp|Q6DEL2|CLPT1_DANRE,Q6DEL2,CLPT1_DANRE,clptm1,631,Danio rerio,2:Experimental evidence at transcript level,Putative lipid scramblase CLPTM1,1,0.999,8,16,16,16,10,6,10,6,10,6,1724574850,509508640,
sp|Q6DEM5|TIM8A_DANRE,Q6DEM5,TIM8A_DANRE,timm8a,90,Danio rerio,3:Protein inferred from homology,Mitochondrial import inner membrane translocase subunit Tim8 A,0.9997,0.999,2,4,4,4,3,1,3,1,3,1,103470392,11730503,
sp|Q6DEN0|UFC1_DANRE,Q6DEN0,UFC1_DANRE,ufc1,166,Danio rerio,2:Experimental evidence at transcript level,Ubiquitin-fold modifier-conjugating enzyme 1,1,0.999,8,32,32,32,15,17,15,17,15,17,2746927870,2011239420,
sp|Q6DG22|ADA_DANRE,Q6DG22,ADA_DANRE,ada,359,Danio rerio,2:Experimental evidence at transcript level,Adenosine deaminase,1,0.999,32,184,184,184,97,87,97,87,97,87,27605381100,17700364300,
sp|Q6DG38|GPAT3_DANRE,Q6DG38,GPAT3_DANRE,gpat3,449,Danio rerio,2:Experimental evidence at transcript level,Glycerol-3-phosphate acyltransferase 3,0.868,0.9956,1,2,2,2,1,1,1,1,1,1,520900608,484695872,
sp|Q6DG60|UBE2Z_DANRE,Q6DG60,UBE2Z_DANRE,ube2z,328,Danio rerio,2:Experimental evidence at transcript level,Ubiquitin-conjugating enzyme E2 Z,1,0.999,7,10,10,10,7,3,7,3,7,3,362472672,95238256,
sp|Q6DG81|PLST_DANRE,Q6DG81,PLST_DANRE,pls3,627,Danio rerio,2:Experimental evidence at transcript level,Plastin-3,1,0.999,37,402,318,402,204,198,163,155,204,198,64770822000,43481784000,
sp|Q6DG85|URIC_DANRE,Q6DG85,URIC_DANRE,uox,298,Danio rerio,1:Experimental evidence at protein level,Uricase,1,0.999,18,109,109,109,57,52,57,52,57,52,10720520200,7445020700,
sp|Q6DG88|ATG4B_DANRE,Q6DG88,ATG4B_DANRE,atg4b,394,Danio rerio,2:Experimental evidence at transcript level,Cysteine protease ATG4B,0.9926,0.9989,2,3,3,3,2,1,2,1,2,1,517187328,39161256,
sp|Q6DG91|PSMG1_DANRE,Q6DG91,PSMG1_DANRE,psmg1,277,Danio rerio,2:Experimental evidence at transcript level,Proteasome assembly chaperone 1,1,0.999,3,3,3,3,3,0,3,0,3,0,131920912,0,
sp|Q6DG99|KCTD6_DANRE,Q6DG99,KCTD6_DANRE,kctd6,237,Danio rerio,2:Experimental evidence at transcript level,BTB/POZ domain-containing protein KCTD6,0.9786,0.999,2,3,3,3,2,1,2,1,2,1,143317248,71283936,
sp|Q6DGA6|ALLC_DANRE,Q6DGA6,ALLC_DANRE,allc,395,Danio rerio,2:Experimental evidence at transcript level,Allantoicase,0.8792,0.9812,2,2,2,2,2,0,2,0,2,0,46797128,0,
sp|Q6DGE9|UN45B_DANRE,Q6DGE9,UN45B_DANRE,unc45b,934,Danio rerio,1:Experimental evidence at protein level,Protein unc-45 homolog B,1,0.999,33,63,63,63,40,23,40,23,40,23,2354195710,1174860930,
sp|Q6DGI3|NOP16_DANRE,Q6DGI3,NOP16_DANRE,nop16,171,Danio rerio,2:Experimental evidence at transcript level,Nucleolar protein 16,0.9814,0.9759,2,5,5,5,4,1,4,1,4,1,211319152,13080776,
sp|Q6DGJ1|GRIFN_DANRE,Q6DGJ1,GRIFN_DANRE,grifin,139,Danio rerio,1:Experimental evidence at protein level,Grifin,1,0.999,12,41,41,41,21,20,21,20,21,20,4235860480,3094357500,
sp|Q6DGJ3|TIM13_DANRE,Q6DGJ3,TIM13_DANRE,timm13,95,Danio rerio,3:Protein inferred from homology,Mitochondrial import inner membrane translocase subunit Tim13,1,0.999,5,14,14,14,7,7,7,7,7,7,720116480,631768450,
sp|Q6DGK2|LDHBB_DANRE,Q6DGK2,LDHBB_DANRE,ldhbb,334,Danio rerio,2:Experimental evidence at transcript level,L-lactate dehydrogenase B-B chain,1,0.999,24,25,25,455,15,10,15,10,239,216,1058050300,579439490,
sp|Q6DGL8|RT15_DANRE,Q6DGL8,RT15_DANRE,mrps15,263,Danio rerio,2:Experimental evidence at transcript level,Small ribosomal subunit protein uS15m,0.9848,0.9971,3,3,3,3,1,2,1,2,1,2,12566978,32555354,
sp|Q6DGQ0|SPT4H_DANRE,Q6DGQ0,SPT4H_DANRE,supt4h1,117,Danio rerio,3:Protein inferred from homology,Transcription elongation factor SPT4,1,0.999,2,7,7,7,4,3,4,3,4,3,232719888,91210400,
sp|Q6DGR4|HGH1_DANRE,Q6DGR4,HGH1_DANRE,hgh1,377,Danio rerio,2:Experimental evidence at transcript level,Protein HGH1 homolog,0.9529,0.998,2,2,2,2,2,0,2,0,2,0,75460712,0,
sp|Q6DGS3|KC2D2_DANRE,Q6DGS3,KC2D2_DANRE,camk2d2,554,Danio rerio,2:Experimental evidence at transcript level,Calcium/calmodulin-dependent protein kinase type II delta 2 chain,1,0.999,30,58,58,200,30,28,30,28,104,96,3931882240,2831699460,
sp|Q6DGV1|CELF4_DANRE,Q6DGV1,CELF4_DANRE,celf4,520,Danio rerio,2:Experimental evidence at transcript level,CUGBP Elav-like family member 4,1,0.9988,7,6,6,15,4,2,4,2,8,7,215721984,123576008,
sp|Q6DGW9|TMCO1_DANRE,Q6DGW9,TMCO1_DANRE,tmco1,188,Danio rerio,2:Experimental evidence at transcript level,Calcium load-activated calcium channel,0.9996,0.999,3,8,8,8,3,5,3,5,3,5,78706848,73422032,
sp|Q6DGY7|CRGNB_DANRE,Q6DGY7,CRGNB_DANRE,crygnb,183,Danio rerio,2:Experimental evidence at transcript level,Gamma-crystallin N-B,1,0.999,24,195,183,195,92,103,86,97,92,103,16856773600,35065700000,
sp|Q6DGZ0|GPT11_DANRE,Q6DGZ0,GPT11_DANRE,gpatch11,262,Danio rerio,2:Experimental evidence at transcript level,G patch domain-containing protein 11,0.9941,0.999,2,5,5,5,3,2,3,2,3,2,250150736,114799152,
sp|Q6DGZ3|THOC7_DANRE,Q6DGZ3,THOC7_DANRE,thoc7,202,Danio rerio,2:Experimental evidence at transcript level,THO complex subunit 7 homolog,1,0.9987,4,6,6,6,4,2,4,2,4,2,154305568,37427708,
sp|Q6DH23|V26BL_DANRE,Q6DH23,V26BL_DANRE,vps26bl,329,Danio rerio,2:Experimental evidence at transcript level,Vacuolar protein sorting-associated protein 26B-like,1,0.999,15,8,8,36,6,2,6,2,23,13,199177040,68994904,
sp|Q6DH42|ENY2_DANRE,Q6DH42,ENY2_DANRE,eny2,95,Danio rerio,3:Protein inferred from homology,Transcription and mRNA export factor ENY2,1,0.999,4,7,7,7,3,4,3,4,3,4,198806752,321273248,
sp|Q6DH44|WDR83_DANRE,Q6DH44,WDR83_DANRE,wdr83,315,Danio rerio,2:Experimental evidence at transcript level,WD repeat domain-containing protein 83,1,0.999,3,4,4,4,3,1,3,1,3,1,172004672,25733654,
sp|Q6DH65|DENR_DANRE,Q6DH65,DENR_DANRE,denr,208,Danio rerio,1:Experimental evidence at protein level,Density-regulated protein,1,0.999,4,10,10,10,7,3,7,3,7,3,520302208,434091392,
sp|Q6DH66|TM20B_DANRE,Q6DH66,TM20B_DANRE,tomm20b,146,Danio rerio,1:Experimental evidence at protein level,Mitochondrial import receptor subunit TOM20 homolog B,0.999,0.9959,2,10,10,10,5,5,5,5,5,5,646367230,626444800,
sp|Q6DH87|FUND1_DANRE,Q6DH87,FUND1_DANRE,fundc1,152,Danio rerio,2:Experimental evidence at transcript level,FUN14 domain-containing protein 1,0.9934,0.999,2,3,3,3,2,1,2,1,2,1,217555344,197429936,
sp|Q6DH88|COX20_DANRE,Q6DH88,COX20_DANRE,cox20,111,Danio rerio,3:Protein inferred from homology,"Cytochrome c oxidase assembly protein COX20, mitochondrial",0.9939,0.999,2,3,3,3,1,2,1,2,1,2,50119740,89114640,
sp|Q6DHB5|LHPL3_DANRE,Q6DHB5,LHPL3_DANRE,lhfpl3,216,Danio rerio,2:Experimental evidence at transcript level,LHFPL tetraspan subfamily member 3 protein,0.4933,0.9707,1,1,1,1,0,1,0,1,0,1,0,24849306,
sp|Q6DHC1|RB18B_DANRE,Q6DHC1,RB18B_DANRE,rab18b,205,Danio rerio,2:Experimental evidence at transcript level,Ras-related protein Rab-18-B,1,0.999,14,57,57,57,32,25,32,25,32,25,3301946620,1561141630,
sp|Q6DHE8|RHOAD_DANRE,Q6DHE8,RHOAD_DANRE,rhoad,193,Danio rerio,1:Experimental evidence at protein level,Rho-related GTP-binding protein RhoA-D,1,0.9986,13,6,6,91,3,3,3,3,47,44,244186624,144043200,
sp|Q6DHG0|SETD7_DANRE,Q6DHG0,SETD7_DANRE,setd7,373,Danio rerio,2:Experimental evidence at transcript level,Histone-lysine N-methyltransferase SETD7,0.9997,0.9987,2,2,2,2,2,0,2,0,2,0,24658184,0,
sp|Q6DHH7|LZIC_DANRE,Q6DHH7,LZIC_DANRE,lzic,190,Danio rerio,1:Experimental evidence at protein level,Protein LZIC,1,0.999,10,27,27,27,11,16,11,16,11,16,1879065730,1772697730,
sp|Q6DHI0|ACY3A_DANRE,Q6DHI0,ACY3A_DANRE,acy3.1,328,Danio rerio,2:Experimental evidence at transcript level,N-acyl-aromatic-L-amino acid amidohydrolase (carboxylate-forming) A,1,0.9985,8,8,8,30,5,3,5,3,17,13,419112832,541522750,
sp|Q6DHI5|SIR5_DANRE,Q6DHI5,SIR5_DANRE,sirt5,305,Danio rerio,1:Experimental evidence at protein level,"NAD-dependent protein deacylase sirtuin-5, mitochondrial",1,0.999,7,16,16,16,11,5,11,5,11,5,904723140,245731856,
sp|Q6DHK1|NNRE_DANRE,Q6DHK1,NNRE_DANRE,naxe,283,Danio rerio,1:Experimental evidence at protein level,NAD(P)H-hydrate epimerase,1,0.999,13,73,73,73,40,33,40,33,40,33,4258225660,3150497540,
sp|Q6DHL4|SUMO2_DANRE,Q6DHL4,SUMO2_DANRE,sumo2,96,Danio rerio,3:Protein inferred from homology,Small ubiquitin-related modifier 2,1,0.999,6,41,41,65,24,17,24,17,36,29,5408892400,3909052160,
sp|Q6DHL5|LRC57_DANRE,Q6DHL5,LRC57_DANRE,lrrc57,238,Danio rerio,2:Experimental evidence at transcript level,Leucine-rich repeat-containing protein 57,1,0.999,10,33,33,33,20,13,20,13,20,13,1323469950,1212377600,
sp|Q6DHM9|RHOAB_DANRE,Q6DHM9,RHOAB_DANRE,rhoab,193,Danio rerio,1:Experimental evidence at protein level,Rho-related GTP-binding protein RhoA-B,1,0.999,12,96,13,96,51,45,8,5,51,45,13994196000,7844685800,
sp|Q6DHN3|TM2D2_DANRE,Q6DHN3,TM2D2_DANRE,tm2d2,229,Danio rerio,2:Experimental evidence at transcript level,TM2 domain-containing protein 2,0.6464,0.9842,1,2,2,2,1,1,1,1,1,1,42355204,31817982,
sp|Q6DHP6|NARF_DANRE,Q6DHP6,NARF_DANRE,narf,465,Danio rerio,2:Experimental evidence at transcript level,Nuclear prelamin A recognition factor,0.9981,0.999,3,3,3,3,1,2,1,2,1,2,34410744,41832648,
sp|Q6DHQ3|ACY3B_DANRE,Q6DHQ3,ACY3B_DANRE,acy3.2,314,Danio rerio,2:Experimental evidence at transcript level,N-acyl-aromatic-L-amino acid amidohydrolase (carboxylate-forming) B,1,0.999,19,63,41,63,38,25,26,15,38,25,4261666300,2589200900,
sp|Q6DHU4|PR38A_DANRE,Q6DHU4,PR38A_DANRE,prpf38a,313,Danio rerio,2:Experimental evidence at transcript level,Pre-mRNA-splicing factor 38A,0.875,0.9958,1,1,1,1,1,0,1,0,1,0,43580400,0,
sp|Q6DHU8|TOPK_DANRE,Q6DHU8,TOPK_DANRE,pbk,339,Danio rerio,2:Experimental evidence at transcript level,Lymphokine-activated killer T-cell-originated protein kinase homolog,1,0.9975,5,7,7,7,5,2,5,2,5,2,521059744,61925040,
sp|Q6DI05|SUMO3_DANRE,Q6DI05,SUMO3_DANRE,sumo3,94,Danio rerio,3:Protein inferred from homology,Small ubiquitin-related modifier 3,1,0.999,7,104,0,104,53,51,0,0,53,51,37115085000,15309610000,sp|Q6NV25|SMO3L_DANRE
sp|Q6DI06|TIM10_DANRE,Q6DI06,TIM10_DANRE,timm10,88,Danio rerio,3:Protein inferred from homology,Mitochondrial import inner membrane translocase subunit Tim10,1,0.999,7,13,13,13,8,5,8,5,8,5,865948990,603036930,
sp|Q6DI35|TFP11_DANRE,Q6DI35,TFP11_DANRE,tfip11,832,Danio rerio,1:Experimental evidence at protein level,Tuftelin-interacting protein 11,1,0.999,5,6,6,6,4,2,4,2,4,2,87960752,200618768,
sp|Q6DI37|UBCP1_DANRE,Q6DI37,UBCP1_DANRE,ublcp1,318,Danio rerio,2:Experimental evidence at transcript level,Ubiquitin-like domain-containing CTD phosphatase 1,1,0.999,11,29,29,29,15,14,15,14,15,14,2999894530,1215859970,
sp|Q6DI40|TTC33_DANRE,Q6DI40,TTC33_DANRE,ttc33,268,Danio rerio,2:Experimental evidence at transcript level,Tetratricopeptide repeat protein 33,0.9999,0.999,2,2,2,2,2,0,2,0,2,0,44696392,0,
sp|Q6DRB1|GLE1_DANRE,Q6DRB1,GLE1_DANRE,gle1,695,Danio rerio,2:Experimental evidence at transcript level,mRNA export factor GLE1,0.9803,0.9931,3,3,3,3,3,0,3,0,3,0,214633680,0,
sp|Q6DRC0|SYSC_DANRE,Q6DRC0,SYSC_DANRE,sars1,515,Danio rerio,1:Experimental evidence at protein level,"Serine--tRNA ligase, cytoplasmic",1,0.999,23,78,78,78,41,37,41,37,41,37,4744247800,4028587010,
sp|Q6DRC4|EIF3G_DANRE,Q6DRC4,EIF3G_DANRE,eif3g,293,Danio rerio,1:Experimental evidence at protein level,Eukaryotic translation initiation factor 3 subunit G,1,0.999,14,56,56,56,26,30,26,30,26,30,3377783550,2732946690,
sp|Q6DRD3|DPOLB_DANRE,Q6DRD3,DPOLB_DANRE,polb,336,Danio rerio,2:Experimental evidence at transcript level,DNA polymerase beta,1,0.999,14,35,35,35,21,14,21,14,21,14,1567495680,759357500,
sp|Q6DRD9|ABHDB_DANRE,Q6DRD9,ABHDB_DANRE,abhd11,317,Danio rerio,2:Experimental evidence at transcript level,sn-1-specific diacylglycerol lipase ABHD11,1,0.9962,7,11,10,11,8,3,7,3,8,3,609030270,121476816,
sp|Q6DRF3|PSB1_DANRE,Q6DRF3,PSB1_DANRE,psmb1,237,Danio rerio,2:Experimental evidence at transcript level,Proteasome subunit beta type-1,1,0.999,12,127,127,127,67,60,67,60,67,60,18879123500,13649945600,
sp|Q6DRF9|WDR55_DANRE,Q6DRF9,WDR55_DANRE,wdr55,387,Danio rerio,2:Experimental evidence at transcript level,WD repeat-containing protein 55,0.7127,0.9883,1,1,1,1,1,0,1,0,1,0,32461820,0,
sp|Q6DRG1|RBM42_DANRE,Q6DRG1,RBM42_DANRE,rbm42,402,Danio rerio,2:Experimental evidence at transcript level,RNA-binding protein 42,0.9998,0.999,3,5,5,5,3,2,3,2,3,2,308463616,168314272,
sp|Q6DRG7|MYPT1_DANRE,Q6DRG7,MYPT1_DANRE,ppp1r12a,1049,Danio rerio,2:Experimental evidence at transcript level,Protein phosphatase 1 regulatory subunit 12A,1,0.999,7,19,19,19,8,11,8,11,8,11,609729470,421062080,
sp|Q6DRI1|EI3EA_DANRE,Q6DRI1,EI3EA_DANRE,eif3ea,446,Danio rerio,2:Experimental evidence at transcript level,Eukaryotic translation initiation factor 3 subunit E-A,1,0.999,17,42,34,42,25,17,20,14,25,17,2356164860,1911811710,
sp|Q6DRI4|RPAC2_DANRE,Q6DRI4,RPAC2_DANRE,polr1d,112,Danio rerio,3:Protein inferred from homology,DNA-directed RNA polymerases I and III subunit RPAC2,0.9014,0.9968,1,2,2,2,1,1,1,1,1,1,46789140,32883862,
sp|Q6DRJ4|KRI1_DANRE,Q6DRJ4,KRI1_DANRE,kri1,765,Danio rerio,2:Experimental evidence at transcript level,Protein KRI1 homolog,0.8903,0.9723,3,3,3,3,2,1,2,1,2,1,28629198,1454621180,
sp|Q6DRJ9|RIC8B_DANRE,Q6DRJ9,RIC8B_DANRE,ric8b,536,Danio rerio,2:Experimental evidence at transcript level,Synembryn-B,1,0.999,9,13,13,13,8,5,8,5,8,5,326628384,341161760,
sp|Q6DRL5|MBB1A_DANRE,Q6DRL5,MBB1A_DANRE,mybbp1a,1269,Danio rerio,1:Experimental evidence at protein level,Myb-binding protein 1A-like protein,0.9948,0.9965,2,2,2,2,2,0,2,0,2,0,52537664,0,
sp|Q6DRP2|GNL3_DANRE,Q6DRP2,GNL3_DANRE,gnl3,561,Danio rerio,2:Experimental evidence at transcript level,Guanine nucleotide-binding protein-like 3,0.3955,0.9571,1,1,1,1,1,0,1,0,1,0,0,0,
sp|Q6DRP4|CCM2_DANRE,Q6DRP4,CCM2_DANRE,ccm2,455,Danio rerio,1:Experimental evidence at protein level,Cerebral cavernous malformations protein 2 homolog,0.9465,0.9983,2,3,3,3,1,2,1,2,1,2,105144648,67598048,
sp|Q6E2N3|TRI33_DANRE,Q6E2N3,TRI33_DANRE,trim33,1163,Danio rerio,2:Experimental evidence at transcript level,E3 ubiquitin-protein ligase TRIM33,1,0.999,7,11,11,11,6,5,6,5,6,5,230537456,131971672,
sp|Q6EIG3|CP26B_DANRE,Q6EIG3,CP26B_DANRE,cyp26b1,511,Danio rerio,1:Experimental evidence at protein level,Cytochrome P450 26B1,0.9913,0.989,3,3,3,3,3,0,3,0,3,0,71218152,0,
sp|Q6EWH2|FYNA_DANRE,Q6EWH2,FYNA_DANRE,fyna,537,Danio rerio,1:Experimental evidence at protein level,Tyrosine-protein kinase fyna,1,0.999,13,6,6,35,4,2,4,2,19,16,153310464,114748360,
sp|Q6GMH0|PRP18_DANRE,Q6GMH0,PRP18_DANRE,prpf18,342,Danio rerio,2:Experimental evidence at transcript level,Pre-mRNA-splicing factor 18,1,0.9987,5,9,9,9,6,3,6,3,6,3,250327792,283020416,
sp|Q6GMH3|TWF2_DANRE,Q6GMH3,TWF2_DANRE,twf2,347,Danio rerio,2:Experimental evidence at transcript level,Twinfilin-2,1,0.999,12,44,44,44,20,24,20,24,20,24,3901356290,2532340480,
sp|Q6GMI7|ENOPH_DANRE,Q6GMI7,ENOPH_DANRE,enoph1,261,Danio rerio,2:Experimental evidence at transcript level,Enolase-phosphatase E1,1,0.999,15,41,41,41,26,15,26,15,26,15,2441722110,1281927420,
sp|Q6GMK7|SH3L2_DANRE,Q6GMK7,SH3L2_DANRE,sh3bgrl2,105,Danio rerio,3:Protein inferred from homology,SH3 domain-binding glutamic acid-rich-like protein 2,0.9989,0.999,2,3,3,3,2,1,2,1,2,1,100171032,49397072,
sp|Q6GMK8|GMPAA_DANRE,Q6GMK8,GMPAA_DANRE,gmppaa,422,Danio rerio,2:Experimental evidence at transcript level,Mannose-1-phosphate guanylyltransferase regulatory subunit alpha-A,1,0.999,11,19,11,19,11,8,6,5,11,8,692677310,559659010,
sp|Q6GML1|CMAH_DANRE,Q6GML1,CMAH_DANRE,cmah,591,Danio rerio,2:Experimental evidence at transcript level,Cytidine monophosphate-N-acetylneuraminic acid hydroxylase,1,0.999,12,19,19,19,11,8,11,8,11,8,1537426690,680261820,
sp|Q6GML7|TATD1_DANRE,Q6GML7,TATD1_DANRE,tatdn1,298,Danio rerio,1:Experimental evidence at protein level,Deoxyribonuclease TATDN1,1,0.999,11,22,22,22,13,9,13,9,13,9,765240700,455964192,
sp|Q6GQM0|MREG_DANRE,Q6GQM0,MREG_DANRE,mreg,234,Danio rerio,2:Experimental evidence at transcript level,Melanoregulin,0.967,0.999,1,2,2,2,1,1,1,1,1,1,38634504,42400744,
sp|Q6GQN8|MECR_DANRE,Q6GQN8,MECR_DANRE,mecr,377,Danio rerio,2:Experimental evidence at transcript level,"Enoyl-[acyl-carrier-protein] reductase, mitochondrial",1,0.999,6,12,12,12,7,5,7,5,7,5,298055104,144436144,
sp|Q6IMK3|DJC27_DANRE,Q6IMK3,DJC27_DANRE,dnajc27,273,Danio rerio,2:Experimental evidence at transcript level,DnaJ homolog subfamily C member 27,1,0.999,5,7,7,7,5,2,5,2,5,2,230319360,115322096,
sp|Q6IQ73|CHM4C_DANRE,Q6IQ73,CHM4C_DANRE,chmp4c,224,Danio rerio,2:Experimental evidence at transcript level,Charged multivesicular body protein 4c,0.9999,0.9989,4,6,4,6,3,3,2,2,3,3,289490688,187400256,
sp|Q6IQ85|YIPF6_DANRE,Q6IQ85,YIPF6_DANRE,yipf6,240,Danio rerio,2:Experimental evidence at transcript level,Protein YIPF6,0.7362,0.9896,1,3,3,3,1,2,1,2,1,2,41380884,37624184,
sp|Q6IQ86|BRK1_DANRE,Q6IQ86,BRK1_DANRE,brk1,75,Danio rerio,3:Protein inferred from homology,Probable protein BRICK1,0.9953,0.9982,2,5,5,5,3,2,3,2,3,2,158178048,159312224,
sp|Q6IQ97|RBM41_DANRE,Q6IQ97,RBM41_DANRE,rbm4.1,419,Danio rerio,1:Experimental evidence at protein level,RNA-binding protein 4.1,1,0.999,16,74,74,74,41,33,41,33,41,33,4364455400,3791376900,
sp|Q6IQC7|TMX2B_DANRE,Q6IQC7,TMX2B_DANRE,tmx2b,307,Danio rerio,2:Experimental evidence at transcript level,Thioredoxin-related transmembrane protein 2-B,1,0.999,10,20,20,20,12,8,12,8,12,8,1309682690,678903360,
sp|Q6IQE0|PU60B_DANRE,Q6IQE0,PU60B_DANRE,puf60b,516,Danio rerio,2:Experimental evidence at transcript level,Poly(U)-binding-splicing factor PUF60-B,1,0.999,21,129,129,129,68,61,68,61,68,61,14291273700,7313717800,
sp|Q6IQE1|PI42C_DANRE,Q6IQE1,PI42C_DANRE,pip4k2c,416,Danio rerio,2:Experimental evidence at transcript level,Phosphatidylinositol 5-phosphate 4-kinase type-2 gamma,0.9995,0.9989,4,5,5,5,2,3,2,3,2,3,62528584,167287008,
sp|Q6IQE5|GET3_DANRE,Q6IQE5,GET3_DANRE,get3,341,Danio rerio,1:Experimental evidence at protein level,ATPase GET3,1,0.999,10,22,22,22,13,9,13,9,13,9,1175129600,794811010,
sp|Q6IQE9|ALKB6_DANRE,Q6IQE9,ALKB6_DANRE,alkbh6,234,Danio rerio,2:Experimental evidence at transcript level,Alpha-ketoglutarate-dependent dioxygenase alkB homolog 6,0.852,0.9863,1,4,4,4,2,2,2,2,2,2,28407782,26461156,
sp|Q6IQM2|CYC_DANRE,Q6IQM2,CYC_DANRE,cyc,104,Danio rerio,3:Protein inferred from homology,Cytochrome c,1,0.999,11,139,84,139,70,69,44,40,70,69,36608668000,28047859700,
sp|Q6IQP3|CALUA_DANRE,Q6IQP3,CALUA_DANRE,calua,315,Danio rerio,2:Experimental evidence at transcript level,Calumenin-A,1,0.999,20,122,108,122,68,54,59,49,68,54,12010725400,7021522400,
sp|Q6IQS6|SAE1_DANRE,Q6IQS6,SAE1_DANRE,sae1,348,Danio rerio,2:Experimental evidence at transcript level,SUMO-activating enzyme subunit 1,1,0.999,33,149,149,149,78,71,78,71,78,71,10984613900,8769774600,
sp|Q6IQT4|CSN2_DANRE,Q6IQT4,CSN2_DANRE,cops2,443,Danio rerio,2:Experimental evidence at transcript level,COP9 signalosome complex subunit 2,1,0.999,29,87,87,87,46,41,46,41,46,41,4902136800,3567555840,
sp|Q6IQU4|CWC15_DANRE,Q6IQU4,CWC15_DANRE,cwc15,243,Danio rerio,2:Experimental evidence at transcript level,Protein CWC15 homolog,0.9834,0.9975,3,3,3,5,1,2,1,2,2,3,24250576,45861120,
sp|Q6IV56|RN141_DANRE,Q6IV56,RN141_DANRE,rnf141,222,Danio rerio,2:Experimental evidence at transcript level,RING finger protein 141,0.9748,0.9986,2,4,4,4,2,2,2,2,2,2,2186599.5,36878292,
sp|Q6IWL4|TRAF6_DANRE,Q6IWL4,TRAF6_DANRE,traf6,542,Danio rerio,1:Experimental evidence at protein level,TNF receptor-associated factor 6,1,0.999,7,11,11,11,9,2,9,2,9,2,169922112,18172886,
sp|Q6NSM8|SIK3_DANRE,Q6NSM8,SIK3_DANRE,zgc:66101,1187,Danio rerio,2:Experimental evidence at transcript level,Serine/threonine-protein kinase SIK3 homolog,0.4519,0.9656,1,1,1,1,0,1,0,1,0,1,0,16597682,
sp|Q6NSN1|LS12B_DANRE,Q6NSN1,LS12B_DANRE,lsm12b,196,Danio rerio,2:Experimental evidence at transcript level,Protein LSM12 homolog B,0.9996,0.9984,3,3,3,8,2,1,2,1,6,2,119227280,41929952,
sp|Q6NSN2|AOF_DANRE,Q6NSN2,AOF_DANRE,mao,522,Danio rerio,1:Experimental evidence at protein level,Amine oxidase [flavin-containing],1,0.999,21,52,52,52,31,21,31,21,31,21,3889617150,1805332350,
sp|Q6NSN5|PURA1_DANRE,Q6NSN5,PURA1_DANRE,adss1,456,Danio rerio,1:Experimental evidence at protein level,Adenylosuccinate synthetase isozyme 1,1,0.999,35,183,168,183,95,88,85,83,95,88,16533469200,12064852000,
sp|Q6NUT7|SORT1_DANRE,Q6NUT7,SORT1_DANRE,sort1,814,Danio rerio,2:Experimental evidence at transcript level,Sortilin,1,0.9989,6,8,8,8,5,3,5,3,5,3,311086848,158899488,
sp|Q6NUV0|RB3GP_DANRE,Q6NUV0,RB3GP_DANRE,rab3gap1,969,Danio rerio,2:Experimental evidence at transcript level,Rab3 GTPase-activating protein catalytic subunit,1,0.999,4,9,9,9,7,2,7,2,7,2,193694864,53647672,
sp|Q6NUW5|AN32E_DANRE,Q6NUW5,AN32E_DANRE,anp32e,250,Danio rerio,1:Experimental evidence at protein level,Acidic leucine-rich nuclear phosphoprotein 32 family member E,1,0.999,13,143,143,143,76,67,76,67,76,67,41236922000,17127465000,
sp|Q6NUW9|FGGY_DANRE,Q6NUW9,FGGY_DANRE,fggy,545,Danio rerio,2:Experimental evidence at transcript level,FGGY carbohydrate kinase domain-containing protein,1,0.9989,6,9,9,9,6,3,6,3,6,3,180445072,138719520,
sp|Q6NUX8|RHOAA_DANRE,Q6NUX8,RHOAA_DANRE,rhoaa,193,Danio rerio,1:Experimental evidence at protein level,Rho-related GTP-binding protein RhoA-A,1,0.999,12,13,8,88,9,4,6,2,48,40,968249150,287898944,
sp|Q6NV04|HACL2_DANRE,Q6NV04,HACL2_DANRE,ilvbl,621,Danio rerio,2:Experimental evidence at transcript level,2-hydroxyacyl-CoA lyase 2,1,0.999,17,32,32,32,19,13,19,13,19,13,1607027710,923093440,
sp|Q6NV24|PXL2B_DANRE,Q6NV24,PXL2B_DANRE,prxl2b,201,Danio rerio,2:Experimental evidence at transcript level,Prostamide/prostaglandin F synthase,1,0.999,8,21,21,21,11,10,11,10,11,10,8864498700,3640694530,
sp|Q6NV31|WDR82_DANRE,Q6NV31,WDR82_DANRE,wdr82,313,Danio rerio,2:Experimental evidence at transcript level,WD repeat-containing protein 82,1,0.999,23,126,126,126,64,62,64,62,64,62,10232022000,6576362000,
sp|Q6NV32|PTMAA_DANRE,Q6NV32,PTMAA_DANRE,ptmaa,105,Danio rerio,2:Experimental evidence at transcript level,Prothymosin alpha-A,1,0.999,6,99,99,99,57,42,57,42,57,42,17314967600,6192674300,
sp|Q6NV34|DECR2_DANRE,Q6NV34,DECR2_DANRE,decr2,300,Danio rerio,2:Experimental evidence at transcript level,"Peroxisomal 2,4-dienoyl-CoA reductase [(3E)-enoyl-CoA-producing]",1,0.999,12,33,33,33,17,16,17,16,17,16,1191080320,868367360,
sp|Q6NVC5|MIRO1_DANRE,Q6NVC5,MIRO1_DANRE,rhot1a,619,Danio rerio,2:Experimental evidence at transcript level,Mitochondrial Rho GTPase 1-A,0.9664,0.999,2,1,1,3,1,0,1,0,2,1,32536388,0,
sp|Q6NW52|MSRB2_DANRE,Q6NW52,MSRB2_DANRE,msrb2,180,Danio rerio,2:Experimental evidence at transcript level,"Methionine-R-sulfoxide reductase B2, mitochondrial",1,0.999,3,8,8,8,4,4,4,4,4,4,650766850,336185056,
sp|Q6NW85|ARI1L_DANRE,Q6NW85,ARI1L_DANRE,arih1l,533,Danio rerio,2:Experimental evidence at transcript level,E3 ubiquitin-protein ligase arih1l,0.9968,0.9986,19,1,1,34,1,0,1,0,21,13,31464536,0,
sp|Q6NWC6|CPSF6_DANRE,Q6NWC6,CPSF6_DANRE,cpsf6,545,Danio rerio,2:Experimental evidence at transcript level,Cleavage and polyadenylation specificity factor subunit 6,1,0.999,12,39,39,39,24,15,24,15,24,15,2548943870,1484692740,
sp|Q6NWC9|GKAP1_DANRE,Q6NWC9,GKAP1_DANRE,gkap1,368,Danio rerio,2:Experimental evidence at transcript level,G kinase-anchoring protein 1,1,0.9974,4,6,6,6,4,2,4,2,4,2,254163168,103735016,
sp|Q6NWD4|TIM50_DANRE,Q6NWD4,TIM50_DANRE,timm50,387,Danio rerio,2:Experimental evidence at transcript level,Mitochondrial import inner membrane translocase subunit TIM50,1,0.9985,6,10,10,10,6,4,6,4,6,4,178912464,162590784,
sp|Q6NWE0|CK054_DANRE,Q6NWE0,CK054_DANRE,zgc:85789,319,Danio rerio,2:Experimental evidence at transcript level,Ester hydrolase C11orf54 homolog,1,0.999,13,53,53,53,30,23,30,23,30,23,2822839300,2096110850,
sp|Q6NWE1|PHF10_DANRE,Q6NWE1,PHF10_DANRE,phf10,490,Danio rerio,2:Experimental evidence at transcript level,PHD finger protein 10,0.9866,0.9989,2,2,2,2,2,0,2,0,2,0,66123404,0,
sp|Q6NWF4|VPS25_DANRE,Q6NWF4,VPS25_DANRE,vps25,174,Danio rerio,2:Experimental evidence at transcript level,Vacuolar protein-sorting-associated protein 25,1,0.999,6,14,14,14,8,6,8,6,8,6,511852576,482824768,
sp|Q6NWF6|K2C8_DANRE,Q6NWF6,K2C8_DANRE,krt8,520,Danio rerio,1:Experimental evidence at protein level,"Keratin, type II cytoskeletal 8",1,0.999,69,1508,1359,1680,754,754,680,679,833,847,643834900000,559055310000,
sp|Q6NWG0|TSN36_DANRE,Q6NWG0,TSN36_DANRE,tspan36,243,Danio rerio,1:Experimental evidence at protein level,Tetraspanin-36,1,0.999,3,24,24,24,11,13,11,13,11,13,2245251070,2237140480,
sp|Q6NWG1|LRC59_DANRE,Q6NWG1,LRC59_DANRE,lrrc59,314,Danio rerio,2:Experimental evidence at transcript level,Leucine-rich repeat-containing protein 59,1,0.999,10,23,23,23,13,10,13,10,13,10,727755260,376727904,
sp|Q6NWG4|ANM6_DANRE,Q6NWG4,ANM6_DANRE,prmt6,349,Danio rerio,2:Experimental evidence at transcript level,Protein arginine N-methyltransferase 6,1,0.999,6,9,9,9,7,2,7,2,7,2,606265470,58615060,
sp|Q6NWH0|CK068_DANRE,Q6NWH0,CK068_DANRE,P5436,249,Danio rerio,2:Experimental evidence at transcript level,UPF0696 protein C11orf68 homolog,1,0.999,6,7,7,11,5,2,5,2,7,4,216145904,75467464,
sp|Q6NWH1|DCA10_DANRE,Q6NWH1,DCA10_DANRE,dcaf10,508,Danio rerio,2:Experimental evidence at transcript level,DDB1- and CUL4-associated factor 10,0.943,0.9773,2,2,2,2,0,2,0,2,0,2,0,124504280,
sp|Q6NWH2|MRPB_DANRE,Q6NWH2,MRPB_DANRE,marcksl1b,207,Danio rerio,2:Experimental evidence at transcript level,MARCKS-related protein 1-B,1,0.999,9,57,57,57,31,26,31,26,31,26,3315570430,1940809730,
sp|Q6NWJ4|DNJC2_DANRE,Q6NWJ4,DNJC2_DANRE,dnajc2,618,Danio rerio,2:Experimental evidence at transcript level,DnaJ homolog subfamily C member 2,0.9999,0.9987,4,7,7,7,4,3,4,3,4,3,209820960,193129792,
sp|Q6NWK2|AP2MA_DANRE,Q6NWK2,AP2MA_DANRE,ap2m1a,436,Danio rerio,2:Experimental evidence at transcript level,AP-2 complex subunit mu-A,1,0.999,26,52,0,52,31,21,0,0,31,21,2138080000,1475479170,sp|Q7ZW98|AP2MB_DANRE
sp|Q6NWL1|PD10B_DANRE,Q6NWL1,PD10B_DANRE,pdcd10b,210,Danio rerio,1:Experimental evidence at protein level,Programmed cell death protein 10-B,1,0.999,10,4,4,26,2,2,2,2,17,9,180478768,40147596,
sp|Q6NWL4|CNOT9_DANRE,Q6NWL4,CNOT9_DANRE,cnot9,298,Danio rerio,2:Experimental evidence at transcript level,CCR4-NOT transcription complex subunit 9,1,0.9989,7,15,15,15,9,6,9,6,9,6,391101536,288698528,
sp|Q6NWX7|NTM1A_DANRE,Q6NWX7,NTM1A_DANRE,ntmt1,223,Danio rerio,2:Experimental evidence at transcript level,N-terminal Xaa-Pro-Lys N-methyltransferase 1,1,0.999,6,8,8,8,6,2,6,2,6,2,359642016,206090672,
sp|Q6NWZ9|CDO1_DANRE,Q6NWZ9,CDO1_DANRE,cdo1,201,Danio rerio,2:Experimental evidence at transcript level,Cysteine dioxygenase type 1,0.9993,0.9974,4,8,8,8,5,3,5,3,5,3,306527552,153694512,
sp|Q6NX08|WDR12_DANRE,Q6NX08,WDR12_DANRE,wdr12,422,Danio rerio,2:Experimental evidence at transcript level,Ribosome biogenesis protein wdr12,1,0.999,18,43,43,43,23,20,23,20,23,20,2857858560,2187408130,
sp|Q6NX89|IF5A1_DANRE,Q6NX89,IF5A1_DANRE,eif5a,155,Danio rerio,1:Experimental evidence at protein level,Eukaryotic translation initiation factor 5A-1,1,0.999,7,144,144,144,72,72,72,72,72,72,41863934000,28313624600,
sp|Q6NXA4|ILF3_DANRE,Q6NXA4,ILF3_DANRE,ilf3,833,Danio rerio,1:Experimental evidence at protein level,Interleukin enhancer-binding factor 3 homolog,1,0.999,40,201,201,201,101,100,101,100,101,100,17150033900,13261909000,
sp|Q6NXA9|UBXN1_DANRE,Q6NXA9,UBXN1_DANRE,ubxn1,294,Danio rerio,2:Experimental evidence at transcript level,UBX domain-containing protein 1,1,0.999,11,40,40,40,20,20,20,20,20,20,2115235840,1541041410,
sp|Q6NXB2|PDZ11_DANRE,Q6NXB2,PDZ11_DANRE,pdzd11,142,Danio rerio,2:Experimental evidence at transcript level,PDZ domain-containing protein 11,0.7043,0.9878,1,1,1,1,1,0,1,0,1,0,5139495.5,0,
sp|Q6NXD2|CHM2B_DANRE,Q6NXD2,CHM2B_DANRE,chmp2b,214,Danio rerio,2:Experimental evidence at transcript level,Charged multivesicular body protein 2b,0.373,0.953,2,3,3,3,2,1,2,1,2,1,70593216,25123922,
sp|Q6NY34|AS1BB_DANRE,Q6NY34,AS1BB_DANRE,asf1bb,197,Danio rerio,2:Experimental evidence at transcript level,Histone chaperone asf1b-B,0.9515,0.9973,2,2,0,2,2,0,0,0,2,0,128667544,0,sp|Q6NYY4|AS1BA_DANRE
sp|Q6NY52|THOC5_DANRE,Q6NY52,THOC5_DANRE,thoc5,684,Danio rerio,2:Experimental evidence at transcript level,THO complex subunit 5 homolog,1,0.999,9,13,13,13,9,4,9,4,9,4,213995024,74830832,
sp|Q6NY64|2ABD_DANRE,Q6NY64,2ABD_DANRE,ppp2r2d,447,Danio rerio,2:Experimental evidence at transcript level,Serine/threonine-protein phosphatase 2A 55 kDa regulatory subunit B delta isoform,1,0.999,22,66,66,66,36,30,36,30,36,30,5569092100,3939153410,
sp|Q6NY73|L3BPB_DANRE,Q6NY73,L3BPB_DANRE,lgals3bpb,572,Danio rerio,2:Experimental evidence at transcript level,Galectin-3-binding protein B,0.9891,0.9908,3,5,3,5,2,3,1,2,2,3,47723336,83821080,
sp|Q6NY74|RFA1_DANRE,Q6NY74,RFA1_DANRE,rpa1,601,Danio rerio,1:Experimental evidence at protein level,Replication protein A 70 kDa DNA-binding subunit,1,0.999,31,114,114,114,57,57,57,57,57,57,6763607000,4152433660,
sp|Q6NY77|HOGA1_DANRE,Q6NY77,HOGA1_DANRE,zgc:77082,324,Danio rerio,2:Experimental evidence at transcript level,"4-hydroxy-2-oxoglutarate aldolase, mitochondrial",1,0.999,20,85,85,85,48,37,48,37,48,37,6784454700,4642385900,
sp|Q6NY82|UBE2F_DANRE,Q6NY82,UBE2F_DANRE,ube2f,185,Danio rerio,2:Experimental evidence at transcript level,NEDD8-conjugating enzyme UBE2F,1,0.999,3,12,12,12,8,4,8,4,8,4,963969540,1745870080,
sp|Q6NY88|CHMP3_DANRE,Q6NY88,CHMP3_DANRE,chmp3,221,Danio rerio,2:Experimental evidence at transcript level,Charged multivesicular body protein 3,1,0.999,13,43,43,43,24,19,24,19,24,19,3226192130,2143818750,
sp|Q6NY89|LSG1_DANRE,Q6NY89,LSG1_DANRE,lsg1,640,Danio rerio,2:Experimental evidence at transcript level,Large subunit GTPase 1 homolog,0.7303,0.9659,1,1,1,1,1,0,1,0,1,0,1416174.5,0,
sp|Q6NY98|MCE1_DANRE,Q6NY98,MCE1_DANRE,rngtt,598,Danio rerio,2:Experimental evidence at transcript level,mRNA-capping enzyme,1,0.9989,7,8,8,8,7,1,7,1,7,1,934872260,51013748,
sp|Q6NYB4|MB211_DANRE,Q6NYB4,MB211_DANRE,mab21l1,359,Danio rerio,2:Experimental evidence at transcript level,Putative nucleotidyltransferase MAB21L1,1,0.999,10,20,5,20,13,7,3,2,13,7,1236875390,767369410,
sp|Q6NYD1|ROMO1_DANRE,Q6NYD1,ROMO1_DANRE,romo1,80,Danio rerio,3:Protein inferred from homology,Reactive oxygen species modulator 1,0.9811,0.9973,2,4,4,4,2,2,2,2,2,2,179153216,121246840,
sp|Q6NYD7|OCAD1_DANRE,Q6NYD7,OCAD1_DANRE,ociad1,266,Danio rerio,2:Experimental evidence at transcript level,OCIA domain-containing protein 1,1,0.999,4,9,9,9,5,4,5,4,5,4,208411216,150610544,
sp|Q6NYE2|RCC2_DANRE,Q6NYE2,RCC2_DANRE,rcc2,495,Danio rerio,2:Experimental evidence at transcript level,Protein RCC2 homolog,1,0.999,18,44,44,44,27,17,27,17,27,17,2445092350,1436491780,
sp|Q6NYF0|LACB2_DANRE,Q6NYF0,LACB2_DANRE,lactb2,289,Danio rerio,2:Experimental evidence at transcript level,Endoribonuclease LACTB2,1,0.999,15,34,34,34,18,16,18,16,18,16,1981223040,2637405440,
sp|Q6NYG6|TDRD3_DANRE,Q6NYG6,TDRD3_DANRE,tdrd3,733,Danio rerio,2:Experimental evidence at transcript level,Tudor domain-containing protein 3,0.9999,0.999,3,3,3,3,2,1,2,1,2,1,78890584,6200644.5,
sp|Q6NYG8|DPYD_DANRE,Q6NYG8,DPYD_DANRE,dpyd,1022,Danio rerio,2:Experimental evidence at transcript level,Dihydropyrimidine dehydrogenase [NADP(+)],1,0.999,36,116,116,116,61,55,61,55,61,55,5329291800,3618459650,
sp|Q6NYL3|ECHP_DANRE,Q6NYL3,ECHP_DANRE,ehhadh,718,Danio rerio,2:Experimental evidence at transcript level,Peroxisomal bifunctional enzyme,0.9659,0.9966,1,2,2,2,1,1,1,1,1,1,29670416,31436194,
sp|Q6NYL5|ALAT2_DANRE,Q6NYL5,ALAT2_DANRE,gpt2l,549,Danio rerio,2:Experimental evidence at transcript level,Alanine aminotransferase 2-like,1,0.999,29,145,145,145,73,72,73,72,73,72,12657323000,10595685400,
sp|Q6NYP0|TM208_DANRE,Q6NYP0,TM208_DANRE,tmem208,175,Danio rerio,2:Experimental evidence at transcript level,Transmembrane protein 208,0.9985,0.9989,2,5,5,5,3,2,3,2,3,2,179675664,86089048,
sp|Q6NYP8|EFMT1_DANRE,Q6NYP8,EFMT1_DANRE,eef1akmt1,166,Danio rerio,2:Experimental evidence at transcript level,EEF1A lysine methyltransferase 1,1,0.999,3,5,5,5,2,3,2,3,2,3,91267592,185259344,
sp|Q6NYR8|NPL_DANRE,Q6NYR8,NPL_DANRE,npl,307,Danio rerio,2:Experimental evidence at transcript level,N-acetylneuraminate lyase,1,0.999,5,9,9,9,6,3,6,3,6,3,644060860,467446464,
sp|Q6NYS8|OST48_DANRE,Q6NYS8,OST48_DANRE,ddost,441,Danio rerio,2:Experimental evidence at transcript level,Dolichyl-diphosphooligosaccharide--protein glycosyltransferase 48 kDa subunit,1,0.999,11,57,57,57,24,33,24,33,24,33,5102505500,4055755780,
sp|Q6NYU2|HELZ_DANRE,Q6NYU2,HELZ_DANRE,helz,1860,Danio rerio,2:Experimental evidence at transcript level,Probable helicase with zinc finger domain,1,0.9989,8,11,11,11,8,3,8,3,8,3,177991728,64784216,
sp|Q6NYU7|UPP_DANRE,Q6NYU7,UPP_DANRE,uprt,257,Danio rerio,2:Experimental evidence at transcript level,Uracil phosphoribosyltransferase homolog,0.9972,0.999,3,3,3,3,3,0,3,0,3,0,148152352,0,
sp|Q6NYV9|LEO1_DANRE,Q6NYV9,LEO1_DANRE,leo1,696,Danio rerio,1:Experimental evidence at protein level,RNA polymerase-associated protein LEO1,0.9562,0.9987,1,2,2,2,1,1,1,1,1,1,193946080,151565456,
sp|Q6NYW6|CLAP2_DANRE,Q6NYW6,CLAP2_DANRE,clasp2,1288,Danio rerio,2:Experimental evidence at transcript level,CLIP-associating protein 2,1,0.999,15,36,36,36,22,14,22,14,22,14,2035061630,949298240,
sp|Q6NYX8|PITH1_DANRE,Q6NYX8,PITH1_DANRE,pithd1,210,Danio rerio,2:Experimental evidence at transcript level,PITH domain-containing protein 1,1,0.999,12,55,55,55,27,28,27,28,27,28,5384728100,3409609980,
sp|Q6NYY9|VMP1_DANRE,Q6NYY9,VMP1_DANRE,vmp1,406,Danio rerio,2:Experimental evidence at transcript level,Vacuole membrane protein 1,0.9778,0.9836,2,2,2,2,1,1,1,1,1,1,1048473.75,14024032,
sp|Q6NYZ4|PLA1A_DANRE,Q6NYZ4,PLA1A_DANRE,pla1a,456,Danio rerio,2:Experimental evidence at transcript level,Phospholipase A1 member A,0.9997,0.999,4,5,5,5,3,2,3,2,3,2,81596368,34662540,
sp|Q6NZ06|ILF2_DANRE,Q6NZ06,ILF2_DANRE,ilf2,387,Danio rerio,2:Experimental evidence at transcript level,Interleukin enhancer-binding factor 2 homolog,1,0.999,20,111,111,111,53,58,53,58,53,58,9952694300,6929145900,
sp|Q6NZ07|NCLN_DANRE,Q6NZ07,NCLN_DANRE,ncln,572,Danio rerio,2:Experimental evidence at transcript level,BOS complex subunit ncln,1,0.999,13,31,31,31,18,13,18,13,18,13,1421567740,1272875010,
sp|Q6NZ09|ADRM1_DANRE,Q6NZ09,ADRM1_DANRE,adrm1b,410,Danio rerio,1:Experimental evidence at protein level,Proteasomal ubiquitin receptor ADRM1,1,0.999,10,57,57,57,31,26,31,26,31,26,3949658620,2067715460,
sp|Q6NZ18|KHDC4_DANRE,Q6NZ18,KHDC4_DANRE,khdc4,570,Danio rerio,2:Experimental evidence at transcript level,KH homology domain-containing protein 4,0.5265,0.9743,1,1,1,1,1,0,1,0,1,0,49992904,0,
sp|Q6NZ22|MET14_DANRE,Q6NZ22,MET14_DANRE,mettl14,455,Danio rerio,2:Experimental evidence at transcript level,N6-adenosine-methyltransferase non-catalytic subunit,0.9996,0.9984,4,9,9,9,4,5,4,5,4,5,210797888,175723152,
sp|Q6NZS4|RTCB_DANRE,Q6NZS4,RTCB_DANRE,rtcb,505,Danio rerio,2:Experimental evidence at transcript level,RNA-splicing ligase RtcB homolog,1,0.999,32,97,97,97,54,43,54,43,54,43,6485384200,7338791400,
sp|Q6NZT2|CDR2L_DANRE,Q6NZT2,CDR2L_DANRE,cdr2l,464,Danio rerio,2:Experimental evidence at transcript level,Cerebellar degeneration-related protein 2-like,0.8487,0.9599,2,3,3,3,2,1,2,1,2,1,73859072,18641060,
sp|Q6NZT6|I2B2A_DANRE,Q6NZT6,I2B2A_DANRE,irf2bp2a,491,Danio rerio,2:Experimental evidence at transcript level,Interferon regulatory factor 2-binding protein 2-A,1,0.999,5,11,2,11,5,6,1,1,5,6,524097184,404737024,
sp|Q6NZW0|C102A_DANRE,Q6NZW0,C102A_DANRE,ccdc102a,581,Danio rerio,2:Experimental evidence at transcript level,Coiled-coil domain-containing protein 102A,0.9996,0.9988,5,5,5,5,3,2,3,2,3,2,102700408,4551932900,
sp|Q6NZW8|AR8BA_DANRE,Q6NZW8,AR8BA_DANRE,arl8ba,186,Danio rerio,2:Experimental evidence at transcript level,ADP-ribosylation factor-like protein 8B-A,1,0.999,13,42,42,42,22,20,22,20,22,20,2022613760,1520413700,
sp|Q6NZZ3|CF120_DANRE,Q6NZZ3,CF120_DANRE,zgc:77929,186,Danio rerio,2:Experimental evidence at transcript level,UPF0669 protein C6orf120 homolog,0.9915,0.9933,3,4,4,4,1,3,1,3,1,3,0,41252032,
sp|Q6NZZ9|RBM22_DANRE,Q6NZZ9,RBM22_DANRE,rbm22,425,Danio rerio,2:Experimental evidence at transcript level,Pre-mRNA-splicing factor RBM22,1,0.999,8,14,14,14,8,6,8,6,8,6,277795072,140867264,
sp|Q6P026|BAF_DANRE,Q6P026,BAF_DANRE,banf1,90,Danio rerio,1:Experimental evidence at protein level,Barrier-to-autointegration factor,1,0.999,6,33,33,33,18,15,18,15,18,15,1624129280,1125471740,
sp|Q6P0B1|CELF2_DANRE,Q6P0B1,CELF2_DANRE,celf2,514,Danio rerio,2:Experimental evidence at transcript level,CUGBP Elav-like family member 2,1,0.999,19,54,38,54,32,22,24,14,32,22,3931528960,2005099390,
sp|Q6P0C7|SCAM5_DANRE,Q6P0C7,SCAM5_DANRE,scamp5,230,Danio rerio,2:Experimental evidence at transcript level,Secretory carrier-associated membrane protein 5,1,0.999,3,14,14,14,8,6,8,6,8,6,1278353150,961768260,
sp|Q6P0D0|QKIA_DANRE,Q6P0D0,QKIA_DANRE,qkia,341,Danio rerio,2:Experimental evidence at transcript level,Protein quaking-A,1,0.999,11,26,18,26,15,11,10,8,15,11,1362485630,968376380,
sp|Q6P0D5|WBP11_DANRE,Q6P0D5,WBP11_DANRE,wbp11,640,Danio rerio,1:Experimental evidence at protein level,WW domain-binding protein 11,0.9896,0.9983,2,3,3,3,1,2,1,2,1,2,60144464,44823316,
sp|Q6P0D9|CIAO1_DANRE,Q6P0D9,CIAO1_DANRE,ciao1,330,Danio rerio,2:Experimental evidence at transcript level,Probable cytosolic iron-sulfur protein assembly protein ciao1,1,0.999,15,42,42,42,23,19,23,19,23,19,2136647680,1365988860,
sp|Q6P0E5|DDRGK_DANRE,Q6P0E5,DDRGK_DANRE,ddrgk1,300,Danio rerio,2:Experimental evidence at transcript level,DDRGK domain-containing protein 1,1,0.999,2,4,4,4,3,1,3,1,3,1,266189712,36748748,
sp|Q6P0G6|MYL1_DANRE,Q6P0G6,MYL1_DANRE,myl1,190,Danio rerio,2:Experimental evidence at transcript level,"Myosin, light chain 1, alkali; skeletal, fast",1,0.999,22,728,728,728,368,360,368,360,368,360,252555264000,188204417000,
sp|Q6P0H6|CSN4_DANRE,Q6P0H6,CSN4_DANRE,cops4,406,Danio rerio,2:Experimental evidence at transcript level,COP9 signalosome complex subunit 4,1,0.999,27,75,75,75,46,29,46,29,46,29,5679519700,3026339070,
sp|Q6P0H7|CBR4_DANRE,Q6P0H7,CBR4_DANRE,cbr4,237,Danio rerio,2:Experimental evidence at transcript level,Carbonyl reductase family member 4,0.7211,0.9888,1,2,2,2,1,1,1,1,1,1,28337936,14654507,
sp|Q6P0I8|EXOS6_DANRE,Q6P0I8,EXOS6_DANRE,exosc6,271,Danio rerio,2:Experimental evidence at transcript level,Exosome complex component MTR3,1,0.999,11,35,35,35,21,14,21,14,21,14,1420323840,714533060,
sp|Q6P0J3|SP8_DANRE,Q6P0J3,SP8_DANRE,sp8b,437,Danio rerio,2:Experimental evidence at transcript level,Transcription factor Sp8,0.9992,0.9985,3,8,1,8,5,3,1,0,5,3,108033832,78390768,
sp|Q6P0U0|NAGA_DANRE,Q6P0U0,NAGA_DANRE,amdhd2,404,Danio rerio,2:Experimental evidence at transcript level,N-acetylglucosamine-6-phosphate deacetylase,1,0.999,8,18,18,18,9,9,9,9,9,9,960769730,777766780,
sp|Q6P0V6|RL8_DANRE,Q6P0V6,RL8_DANRE,rpl8,257,Danio rerio,1:Experimental evidence at protein level,Large ribosomal subunit protein uL2,1,0.999,16,46,46,46,17,29,17,29,17,29,2306874880,3900978690,
sp|Q6P104|QKIB_DANRE,Q6P104,QKIB_DANRE,qki2,319,Danio rerio,2:Experimental evidence at transcript level,Protein quaking-B,1,0.999,9,13,13,21,7,6,7,6,12,9,636087170,470898272,
sp|Q6P116|RCOR2_DANRE,Q6P116,RCOR2_DANRE,rcor2,536,Danio rerio,2:Experimental evidence at transcript level,REST corepressor 2,0.951,0.998,2,2,2,2,2,0,2,0,2,0,31624762,0,
sp|Q6P132|TXB1B_DANRE,Q6P132,TXB1B_DANRE,tax1bp1b,823,Danio rerio,2:Experimental evidence at transcript level,Tax1-binding protein 1 homolog B,0.5998,0.9808,2,1,1,2,1,0,1,0,2,0,149094816,0,
sp|Q6P135|TMUB1_DANRE,Q6P135,TMUB1_DANRE,tmub1,292,Danio rerio,2:Experimental evidence at transcript level,Transmembrane and ubiquitin-like domain-containing protein 1,0.9851,0.9986,1,2,2,2,1,1,1,1,1,1,0,25624820,
sp|Q6P268|PDCL3_DANRE,Q6P268,PDCL3_DANRE,pdcl3,239,Danio rerio,2:Experimental evidence at transcript level,Phosducin-like protein 3,1,0.999,7,25,25,25,11,14,11,14,11,14,2038216960,936966270,
sp|Q6P2A1|PRDM9_DANRE,Q6P2A1,PRDM9_DANRE,prdm9,853,Danio rerio,2:Experimental evidence at transcript level,Histone-lysine N-methyltransferase PRDM9,0.8675,0.9955,1,1,1,1,1,0,1,0,1,0,16864136,0,
sp|Q6P2T0|TM38A_DANRE,Q6P2T0,TM38A_DANRE,tmem38a,295,Danio rerio,2:Experimental evidence at transcript level,Trimeric intracellular cation channel type A,1,0.999,5,11,11,11,5,6,5,6,5,6,246053056,195682352,
sp|Q6P2T7|CD033_DANRE,Q6P2T7,CD033_DANRE,zgc:77739,197,Danio rerio,2:Experimental evidence at transcript level,UPF0462 protein C4orf33 homolog,1,0.999,6,15,15,15,9,6,9,6,9,6,727612160,500220352,
sp|Q6P2U9|CSN3_DANRE,Q6P2U9,CSN3_DANRE,cops3,423,Danio rerio,2:Experimental evidence at transcript level,COP9 signalosome complex subunit 3,1,0.999,21,64,64,64,38,26,38,26,38,26,3996231170,2325134590,
sp|Q6P3H4|PNCB_DANRE,Q6P3H4,PNCB_DANRE,naprt,546,Danio rerio,2:Experimental evidence at transcript level,Nicotinate phosphoribosyltransferase,1,0.999,11,18,18,18,10,8,10,8,10,8,742059010,357547744,
sp|Q6P3H7|RBBP4_DANRE,Q6P3H7,RBBP4_DANRE,rbbp4,424,Danio rerio,2:Experimental evidence at transcript level,Histone-binding protein RBBP4,1,0.999,28,238,102,238,132,106,59,43,132,106,38360625000,28510255100,
sp|Q6P3J5|EF2_DANRE,Q6P3J5,EF2_DANRE,eef2b,858,Danio rerio,1:Experimental evidence at protein level,Elongation factor 2b,1,0.999,100,1918,1918,1918,993,925,993,925,993,925,457802383000,325655527000,
sp|Q6P3K7|KC1DB_DANRE,Q6P3K7,KC1DB_DANRE,csnk1db,409,Danio rerio,2:Experimental evidence at transcript level,Casein kinase I isoform delta-B,1,0.999,11,24,0,24,16,8,0,0,16,8,871592130,275432384,sp|Q7T2E3|KC1DA_DANRE
sp|Q6P3L0|MVP_DANRE,Q6P3L0,MVP_DANRE,mvp,863,Danio rerio,2:Experimental evidence at transcript level,Major vault protein,1,0.999,46,156,156,156,74,82,74,82,74,82,9506342900,8263582700,
sp|Q6P3L6|DH12A_DANRE,Q6P3L6,DH12A_DANRE,hsd17b12a,319,Danio rerio,2:Experimental evidence at transcript level,Very-long-chain 3-oxoacyl-CoA reductase-A,1,0.999,9,31,15,31,17,14,9,6,17,14,2458865660,742860220,
sp|Q6P5I8|YIPF5_DANRE,Q6P5I8,YIPF5_DANRE,yipf5,257,Danio rerio,2:Experimental evidence at transcript level,Protein YIPF5,0.808,0.9931,1,4,4,4,2,2,2,2,2,2,377960384,326392576,
sp|Q6P5L3|RL19_DANRE,Q6P5L3,RL19_DANRE,rpl19,196,Danio rerio,1:Experimental evidence at protein level,Large ribosomal subunit protein eL19,1,0.999,13,64,64,64,33,31,33,31,33,31,3620916480,3461973500,
sp|Q6P5L7|ARGLA_DANRE,Q6P5L7,ARGLA_DANRE,arglu1a,251,Danio rerio,2:Experimental evidence at transcript level,Arginine and glutamate-rich protein 1-A,0.7996,0.9766,5,2,2,9,1,1,1,1,5,4,115617056,99665160,
sp|Q6P5L8|HSDL2_DANRE,Q6P5L8,HSDL2_DANRE,hsdl2,415,Danio rerio,2:Experimental evidence at transcript level,Hydroxysteroid dehydrogenase-like protein 2,1,0.999,25,234,234,234,125,109,125,109,125,109,27595225100,18430423000,
sp|Q6P5M2|SKI8_DANRE,Q6P5M2,SKI8_DANRE,skic8,305,Danio rerio,2:Experimental evidence at transcript level,Superkiller complex protein 8,1,0.999,15,54,54,54,31,23,31,23,31,23,3502993660,2515466500,
sp|Q6P698|PLSL_DANRE,Q6P698,PLSL_DANRE,lcp1,624,Danio rerio,1:Experimental evidence at protein level,Plastin-2,1,0.999,40,108,108,192,52,56,52,56,93,99,6608646100,4839050800,
sp|Q6P6X9|NUP35_DANRE,Q6P6X9,NUP35_DANRE,nup35,308,Danio rerio,1:Experimental evidence at protein level,Nucleoporin NUP35,0.6302,0.9831,1,2,2,2,1,1,1,1,1,1,65210188,33813872,
sp|Q6P6Y1|RELCH_DANRE,Q6P6Y1,RELCH_DANRE,relch,1189,Danio rerio,2:Experimental evidence at transcript level,RAB11-binding protein RELCH homolog,1,0.999,8,13,13,13,9,4,9,4,9,4,1724158720,96141000,
sp|Q6P7E4|PDLI7_DANRE,Q6P7E4,PDLI7_DANRE,pdlim7,419,Danio rerio,2:Experimental evidence at transcript level,PDZ and LIM domain protein 7,1,0.999,17,99,99,99,53,46,53,46,53,46,13059759100,11490629600,
sp|Q6P7Y3|PR38B_DANRE,Q6P7Y3,PR38B_DANRE,prpf38b,501,Danio rerio,2:Experimental evidence at transcript level,Pre-mRNA-splicing factor 38B,0.8993,0.9954,2,4,4,4,3,1,3,1,3,1,87604896,28665542,
sp|Q6P949|PHF2_DANRE,Q6P949,PHF2_DANRE,phf2,1063,Danio rerio,2:Experimental evidence at transcript level,Lysine-specific demethylase phf2,0.9127,0.9756,3,4,4,4,1,3,1,3,1,3,1686841860,1810607230,
sp|Q6P963|GLO2_DANRE,Q6P963,GLO2_DANRE,hagh,303,Danio rerio,2:Experimental evidence at transcript level,"Hydroxyacylglutathione hydrolase, mitochondrial",1,0.999,19,114,114,114,58,56,58,56,58,56,7385857500,5889392100,
sp|Q6P964|P4R2A_DANRE,Q6P964,P4R2A_DANRE,ppp4r2a,420,Danio rerio,2:Experimental evidence at transcript level,Serine/threonine-protein phosphatase 4 regulatory subunit 2-A,1,0.999,4,8,4,8,4,4,2,2,4,4,342975648,112877000,
sp|Q6PBA2|LS12A_DANRE,Q6PBA2,LS12A_DANRE,lsm12a,196,Danio rerio,2:Experimental evidence at transcript level,Protein LSM12 homolog A,1,0.999,4,19,14,19,12,7,8,6,12,7,921687170,684275840,
sp|Q6PBH5|NDUA4_DANRE,Q6PBH5,NDUA4_DANRE,ndufa4,82,Danio rerio,3:Protein inferred from homology,Cytochrome c oxidase subunit NDUFA4,1,0.9987,5,19,19,19,10,9,10,9,10,9,1003069250,971007100,
sp|Q6PBI5|RS25_DANRE,Q6PBI5,RS25_DANRE,rps25,124,Danio rerio,1:Experimental evidence at protein level,Small ribosomal subunit protein eS25,1,0.9989,7,46,46,46,21,25,21,25,21,25,5374041100,3902541310,
sp|Q6PBI8|TM177_DANRE,Q6PBI8,TM177_DANRE,tmem177,310,Danio rerio,2:Experimental evidence at transcript level,Transmembrane protein 177,0.8458,0.9829,1,1,1,1,1,0,1,0,1,0,12642560,0,
sp|Q6PBK1|MIX23_DANRE,Q6PBK1,MIX23_DANRE,mix23,144,Danio rerio,2:Experimental evidence at transcript level,Protein MIX23,1,0.999,9,17,17,17,11,6,11,6,11,6,637126340,418488800,
sp|Q6PBK3|RS28_DANRE,Q6PBK3,RS28_DANRE,rps28,69,Danio rerio,1:Experimental evidence at protein level,Small ribosomal subunit protein eS28,1,0.999,6,29,29,29,14,15,14,15,14,15,4043027200,3107938820,
sp|Q6PBL0|TIM16_DANRE,Q6PBL0,TIM16_DANRE,pam16,129,Danio rerio,2:Experimental evidence at transcript level,Mitochondrial import inner membrane translocase subunit tim16,0.4898,0.9703,1,2,2,2,1,1,1,1,1,1,67308768,31353876,
sp|Q6PBM1|GLRX5_DANRE,Q6PBM1,GLRX5_DANRE,glrx5,155,Danio rerio,2:Experimental evidence at transcript level,"Glutaredoxin-related protein 5, mitochondrial",1,0.999,6,9,9,9,5,4,5,4,5,4,328266208,153914112,
sp|Q6PBM7|FA76B_DANRE,Q6PBM7,FA76B_DANRE,fam76b,328,Danio rerio,1:Experimental evidence at protein level,Protein FAM76B,1,0.999,7,18,18,18,10,8,10,8,10,8,575774780,420011104,
sp|Q6PBP3|PXL2A_DANRE,Q6PBP3,PXL2A_DANRE,prxl2a,212,Danio rerio,2:Experimental evidence at transcript level,Peroxiredoxin-like 2A,1,0.9989,7,9,9,9,5,4,5,4,5,4,537758850,335936960,
sp|Q6PBQ2|CHMP7_DANRE,Q6PBQ2,CHMP7_DANRE,chmp7,457,Danio rerio,2:Experimental evidence at transcript level,Charged multivesicular body protein 7,0.6877,0.9868,1,1,1,1,1,0,1,0,1,0,12321963,0,
sp|Q6PBS3|SYWC_DANRE,Q6PBS3,SYWC_DANRE,wars,463,Danio rerio,2:Experimental evidence at transcript level,"Tryptophan--tRNA ligase, cytoplasmic",1,0.999,16,30,30,30,13,17,13,17,13,17,667011970,832475840,
sp|Q6PBS6|TM258_DANRE,Q6PBS6,TM258_DANRE,tmem258,79,Danio rerio,3:Protein inferred from homology,Transmembrane protein 258,0.8281,0.9939,1,3,3,3,1,2,1,2,1,2,85121600,83373480,
sp|Q6PBT5|PYRD1_DANRE,Q6PBT5,PYRD1_DANRE,pyroxd1,490,Danio rerio,2:Experimental evidence at transcript level,Pyridine nucleotide-disulfide oxidoreductase domain-containing protein 1,0.9137,0.9947,2,3,3,3,2,1,2,1,2,1,74705424,33367232,
sp|Q6PBT6|GFRP_DANRE,Q6PBT6,GFRP_DANRE,gchfr,89,Danio rerio,3:Protein inferred from homology,GTP cyclohydrolase 1 feedback regulatory protein,1,0.999,2,7,7,7,4,3,4,3,4,3,224188672,262422832,
sp|Q6PBU0|F136A_DANRE,Q6PBU0,F136A_DANRE,fam136a,138,Danio rerio,2:Experimental evidence at transcript level,Protein FAM136A,1,0.999,9,26,26,26,13,13,13,13,13,13,1597923970,1530814720,
sp|Q6PBU7|UQCC2_DANRE,Q6PBU7,UQCC2_DANRE,uqcc2,129,Danio rerio,2:Experimental evidence at transcript level,Ubiquinol-cytochrome-c reductase complex assembly factor 2,1,0.999,6,11,11,11,8,3,8,3,8,3,465867424,211271344,
sp|Q6PBV6|NHP2_DANRE,Q6PBV6,NHP2_DANRE,nhp2,150,Danio rerio,2:Experimental evidence at transcript level,H/ACA ribonucleoprotein complex subunit 2-like protein,1,0.999,3,5,5,5,4,1,4,1,4,1,92425312,48568332,
sp|Q6PBW5|RP65A_DANRE,Q6PBW5,RP65A_DANRE,rpe65a,531,Danio rerio,2:Experimental evidence at transcript level,Retinoid isomerohydrolase,1,0.999,36,223,223,223,115,108,115,108,115,108,16996844500,14128434200,
sp|Q6PBX5|MTND_DANRE,Q6PBX5,MTND_DANRE,adi1,181,Danio rerio,2:Experimental evidence at transcript level,Acireductone dioxygenase,1,0.999,8,22,22,22,14,8,14,8,14,8,1593538050,931661700,
sp|Q6PBX9|REEP5_DANRE,Q6PBX9,REEP5_DANRE,reep5,189,Danio rerio,1:Experimental evidence at protein level,Receptor expression-enhancing protein 5,1,0.9982,4,26,26,26,13,13,13,13,13,13,1863604740,19878080500,
sp|Q6PBY0|GNB5B_DANRE,Q6PBY0,GNB5B_DANRE,gnb5b,395,Danio rerio,2:Experimental evidence at transcript level,Guanine nucleotide-binding protein subunit beta-5b,1,0.999,20,53,41,53,29,24,22,19,29,24,3370825470,1884385020,
sp|Q6PBY1|RS3A_DANRE,Q6PBY1,RS3A_DANRE,rps3a,267,Danio rerio,1:Experimental evidence at protein level,Small ribosomal subunit protein eS1,1,0.999,23,78,78,78,36,42,36,42,36,42,3834649340,6371229200,
sp|Q6PBY7|TPC13_DANRE,Q6PBY7,TPC13_DANRE,trappc13,412,Danio rerio,2:Experimental evidence at transcript level,Trafficking protein particle complex subunit 13,1,0.999,4,5,5,5,3,2,3,2,3,2,1924197120,401606208,
sp|Q6PC14|RL23_DANRE,Q6PC14,RL23_DANRE,rpl23,140,Danio rerio,1:Experimental evidence at protein level,Large ribosomal subunit protein uL14,1,0.999,6,27,27,27,11,16,11,16,11,16,1009107390,1264171140,
sp|Q6PC19|SSU72_DANRE,Q6PC19,SSU72_DANRE,ssu72,194,Danio rerio,2:Experimental evidence at transcript level,RNA polymerase II subunit A C-terminal domain phosphatase SSU72,1,0.999,7,18,18,18,10,8,10,8,10,8,978543170,410923712,
sp|Q6PC29|143G1_DANRE,Q6PC29,143G1_DANRE,ywhag1,247,Danio rerio,2:Experimental evidence at transcript level,14-3-3 protein gamma-1,1,0.999,26,156,156,457,86,70,86,70,225,232,27025995800,19232751600,
sp|Q6PC30|CSN5_DANRE,Q6PC30,CSN5_DANRE,cops5,334,Danio rerio,2:Experimental evidence at transcript level,COP9 signalosome complex subunit 5,1,0.999,13,35,35,35,19,16,19,16,19,16,1826038660,1114559230,
sp|Q6PC54|SN25B_DANRE,Q6PC54,SN25B_DANRE,snap25b,203,Danio rerio,2:Experimental evidence at transcript level,Synaptosomal-associated protein 25-B,1,0.999,9,6,6,28,3,3,3,3,15,13,195582688,144747600,
sp|Q6PC69|RL10A_DANRE,Q6PC69,RL10A_DANRE,rpl10a,216,Danio rerio,2:Experimental evidence at transcript level,Large ribosomal subunit protein uL1,1,0.999,17,158,158,158,74,84,74,84,74,84,27080640500,21314113500,
sp|Q6PC78|RN185_DANRE,Q6PC78,RN185_DANRE,rnf185,194,Danio rerio,2:Experimental evidence at transcript level,E3 ubiquitin-protein ligase RNF185,0.4149,0.9603,1,2,2,2,1,1,1,1,1,1,51468928,70477048,
sp|Q6PC91|BT3L4_DANRE,Q6PC91,BT3L4_DANRE,btf3l4,158,Danio rerio,2:Experimental evidence at transcript level,Transcription factor BTF3 homolog 4,1,0.999,7,18,18,18,12,6,12,6,12,6,1338534530,769772740,
sp|Q6PCR6|ZFR_DANRE,Q6PCR6,ZFR_DANRE,zfr,1074,Danio rerio,2:Experimental evidence at transcript level,Zinc finger RNA-binding protein,1,0.999,20,47,47,47,26,21,26,21,26,21,3168603140,2031296380,
sp|Q6PCR7|EIF3A_DANRE,Q6PCR7,EIF3A_DANRE,eif3a,1267,Danio rerio,2:Experimental evidence at transcript level,Eukaryotic translation initiation factor 3 subunit A,1,0.999,59,204,200,204,103,101,101,99,103,101,12606199800,10550807600,
sp|Q6PD83|5MP2A_DANRE,Q6PD83,5MP2A_DANRE,bzw1a,419,Danio rerio,2:Experimental evidence at transcript level,eIF5-mimic protein 2-A,1,0.999,26,107,81,107,52,55,41,40,52,55,9141138400,6492172300,
sp|Q6PD99|MRPA_DANRE,Q6PD99,MRPA_DANRE,marcksl1a,213,Danio rerio,2:Experimental evidence at transcript level,MARCKS-related protein 1-A,1,0.999,7,22,22,22,13,9,13,9,13,9,1216107260,583144510,
sp|Q6PE18|P4K2A_DANRE,Q6PE18,P4K2A_DANRE,pi4k2a,447,Danio rerio,2:Experimental evidence at transcript level,Phosphatidylinositol 4-kinase type 2-alpha,0.9571,0.9902,2,3,1,3,1,2,0,1,1,2,256776544,240918432,
sp|Q6PE25|EF1G_DANRE,Q6PE25,EF1G_DANRE,eef1g,442,Danio rerio,2:Experimental evidence at transcript level,Elongation factor 1-gamma,1,0.999,33,252,252,252,139,113,139,113,139,113,40111702000,23496845300,
sp|Q6PEH5|UB2V2_DANRE,Q6PEH5,UB2V2_DANRE,ube2v2,145,Danio rerio,2:Experimental evidence at transcript level,Ubiquitin-conjugating enzyme E2 variant 2,1,0.999,18,171,171,171,92,79,92,79,92,79,15612324900,24197449700,
sp|Q6PEH8|MED25_DANRE,Q6PEH8,MED25_DANRE,med25,701,Danio rerio,2:Experimental evidence at transcript level,Mediator of RNA polymerase II transcription subunit 25,0.9316,0.9979,1,1,1,1,1,0,1,0,1,0,48800696,0,
sp|Q6PEI7|PYRG1_DANRE,Q6PEI7,PYRG1_DANRE,ctps1,591,Danio rerio,1:Experimental evidence at protein level,CTP synthase 1,1,0.999,25,57,57,57,33,24,33,24,33,24,2679127300,1576871040,
sp|Q6PFJ7|NSMA3_DANRE,Q6PFJ7,NSMA3_DANRE,smpd4,791,Danio rerio,2:Experimental evidence at transcript level,Sphingomyelin phosphodiesterase 4,1,0.9964,6,9,9,9,6,3,6,3,6,3,676654590,68194552,
sp|Q6PFJ9|ARI1_DANRE,Q6PFJ9,ARI1_DANRE,arih1,527,Danio rerio,2:Experimental evidence at transcript level,E3 ubiquitin-protein ligase arih1,1,0.999,20,36,3,36,22,14,2,1,22,14,1594071170,1051552000,
sp|Q6PFK1|ZN598_DANRE,Q6PFK1,ZN598_DANRE,znf598,953,Danio rerio,1:Experimental evidence at protein level,E3 ubiquitin-protein ligase ZNF598,1,0.999,8,12,12,12,7,5,7,5,7,5,564148540,344491744,
sp|Q6PFL6|CCD43_DANRE,Q6PFL6,CCD43_DANRE,ccdc43,213,Danio rerio,2:Experimental evidence at transcript level,Coiled-coil domain-containing protein 43,0.5517,0.9767,1,1,1,1,1,0,1,0,1,0,49687268,0,
sp|Q6PFL8|THYN1_DANRE,Q6PFL8,THYN1_DANRE,thyn1,231,Danio rerio,2:Experimental evidence at transcript level,Thymocyte nuclear protein 1,0.9663,0.9984,2,3,3,3,2,1,2,1,2,1,139897568,62002752,
sp|Q6PFM4|LNPB_DANRE,Q6PFM4,LNPB_DANRE,lnpkb,402,Danio rerio,2:Experimental evidence at transcript level,Endoplasmic reticulum junction formation protein lunapark-B,0.5079,0.9724,1,2,2,2,2,0,2,0,2,0,39152840,0,
sp|Q6PFM9|WDR48_DANRE,Q6PFM9,WDR48_DANRE,wdr48,677,Danio rerio,2:Experimental evidence at transcript level,WD repeat-containing protein 48,1,0.9989,7,10,10,10,7,3,7,3,7,3,278903968,87770928,
sp|Q6PFP6|NDOR1_DANRE,Q6PFP6,NDOR1_DANRE,ndor1,595,Danio rerio,2:Experimental evidence at transcript level,NADPH-dependent diflavin oxidoreductase 1,0.9663,0.999,1,1,1,1,1,0,1,0,1,0,17024546,0,
sp|Q6PFQ0|KS6A6_DANRE,Q6PFQ0,KS6A6_DANRE,rps6ka6,740,Danio rerio,2:Experimental evidence at transcript level,Ribosomal protein S6 kinase alpha-6,1,0.999,12,39,35,39,21,18,19,16,21,18,2373945600,1442048260,
sp|Q6PFQ2|EIF3C_DANRE,Q6PFQ2,EIF3C_DANRE,eif3c,926,Danio rerio,1:Experimental evidence at protein level,Eukaryotic translation initiation factor 3 subunit C,1,0.999,32,74,72,74,42,32,41,31,42,32,5030898200,3124653570,
sp|Q6PFS2|PRXD1_DANRE,Q6PFS2,PRXD1_DANRE,Prorsd1,184,Danio rerio,2:Experimental evidence at transcript level,Prolyl-tRNA synthetase associated domain-containing protein 1,0.474,0.9685,1,1,1,1,1,0,1,0,1,0,33528310,0,
sp|Q6PFS7|ATG3_DANRE,Q6PFS7,ATG3_DANRE,atg3,317,Danio rerio,2:Experimental evidence at transcript level,Ubiquitin-like-conjugating enzyme ATG3,1,0.999,9,31,31,31,16,15,16,15,16,15,1830818690,1578502140,
sp|Q6PGV1|VA0D1_DANRE,Q6PGV1,VA0D1_DANRE,atp6v0d1,350,Danio rerio,1:Experimental evidence at protein level,V-type proton ATPase subunit d 1,1,0.999,14,80,80,80,42,38,42,38,42,38,8679523300,5814046200,
sp|Q6PGW3|ARMD3_DANRE,Q6PGW3,ARMD3_DANRE,armh3,689,Danio rerio,2:Experimental evidence at transcript level,Armadillo-like helical domain-containing protein 3,1,0.999,7,13,13,13,9,4,9,4,9,4,661832000,204581120,
sp|Q6PGY5|DJC21_DANRE,Q6PGY5,DJC21_DANRE,dnajc21,545,Danio rerio,2:Experimental evidence at transcript level,DnaJ homolog subfamily C member 21,0.962,0.9988,1,3,3,3,2,1,2,1,2,1,43772320,18268602,
sp|Q6PGY6|UFL1_DANRE,Q6PGY6,UFL1_DANRE,ufl1,793,Danio rerio,2:Experimental evidence at transcript level,E3 UFM1-protein ligase 1,1,0.999,4,6,6,6,5,1,5,1,5,1,121119432,25723852,
sp|Q6PH11|PYM1_DANRE,Q6PH11,PYM1_DANRE,pym1,194,Danio rerio,2:Experimental evidence at transcript level,Partner of Y14 and mago,0.9609,0.9988,1,1,1,1,1,0,1,0,1,0,16334103,0,
sp|Q6PH19|GATM_DANRE,Q6PH19,GATM_DANRE,gatm,422,Danio rerio,2:Experimental evidence at transcript level,"Glycine amidinotransferase, mitochondrial",1,0.999,36,316,316,316,169,147,169,147,169,147,45078430000,35139588000,
sp|Q6PH37|ST1S1_DANRE,Q6PH37,ST1S1_DANRE,sult1st1,299,Danio rerio,1:Experimental evidence at protein level,Cytosolic sulfotransferase 1,1,0.999,7,14,8,14,7,7,5,3,7,7,752847420,2356643330,
sp|Q6PH52|PCH2_DANRE,Q6PH52,PCH2_DANRE,trip13,424,Danio rerio,2:Experimental evidence at transcript level,Pachytene checkpoint protein 2 homolog,0.884,0.9962,2,2,2,2,2,0,2,0,2,0,44203224,0,
sp|Q6PH57|GBB1_DANRE,Q6PH57,GBB1_DANRE,gnb1,340,Danio rerio,2:Experimental evidence at transcript level,Guanine nucleotide-binding protein G(I)/G(S)/G(T) subunit beta-1,1,0.999,25,252,252,252,121,131,121,131,121,131,44729291000,39182926000,
sp|Q6PHD9|SBP1_DANRE,Q6PHD9,SBP1_DANRE,selenbp1,457,Danio rerio,2:Experimental evidence at transcript level,Methanethiol oxidase,1,0.999,23,149,149,149,76,73,76,73,76,73,14641964000,11800118300,
sp|Q6PHE8|CC124_DANRE,Q6PHE8,CC124_DANRE,ccdc124,216,Danio rerio,2:Experimental evidence at transcript level,Coiled-coil domain-containing protein 124,0.9997,0.9986,2,4,4,4,2,2,2,2,2,2,126859344,62058232,
sp|Q6PHF0|CHM1A_DANRE,Q6PHF0,CHM1A_DANRE,chmp1a,198,Danio rerio,2:Experimental evidence at transcript level,Charged multivesicular body protein 1a,0.9993,0.9989,2,3,3,3,2,1,2,1,2,1,75358272,12173628,
sp|Q6PHG2|HEMO_DANRE,Q6PHG2,HEMO_DANRE,hpx,447,Danio rerio,2:Experimental evidence at transcript level,Hemopexin,0.9961,0.9964,2,2,2,2,2,0,2,0,2,0,55010456,0,
sp|Q6PHG4|LIAS_DANRE,Q6PHG4,LIAS_DANRE,lias,399,Danio rerio,2:Experimental evidence at transcript level,"Lipoyl synthase, mitochondrial",0.9999,0.999,3,4,4,4,3,1,3,1,3,1,98279448,9374353,
sp|Q6PHH3|PD10A_DANRE,Q6PHH3,PD10A_DANRE,pdcd10a,210,Danio rerio,1:Experimental evidence at protein level,Programmed cell death protein 10-A,1,0.999,11,25,3,25,17,8,2,1,17,8,1398391940,768360700,
sp|Q6PHI9|RAB4A_DANRE,Q6PHI9,RAB4A_DANRE,rab4a,213,Danio rerio,2:Experimental evidence at transcript level,Ras-related protein Rab-4A,1,0.999,8,57,10,57,26,31,5,5,26,31,6053001200,5142410800,
sp|Q6PHK6|PURB_DANRE,Q6PHK6,PURB_DANRE,purb,297,Danio rerio,2:Experimental evidence at transcript level,Transcriptional regulator protein Pur-beta,1,0.999,12,72,72,72,32,40,32,40,32,40,10057304100,7446358000,
sp|Q6PI20|H33_DANRE,Q6PI20,H33_DANRE,h3f3a,136,Danio rerio,2:Experimental evidence at transcript level,Histone H3.3,1,0.9963,15,7,7,305,4,3,4,3,170,135,443964832,200989552,
sp|Q6PI52|CALM_DANRE,Q6PI52,CALM_DANRE,calm1a,149,Danio rerio,2:Experimental evidence at transcript level,Calmodulin,1,0.999,16,693,693,693,330,363,330,363,330,363,541954638000,419803693000,
sp|Q6PUF3|DHI1L_DANRE,Q6PUF3,DHI1L_DANRE,hsd11b1l,287,Danio rerio,2:Experimental evidence at transcript level,Hydroxysteroid 11-beta-dehydrogenase 1-like protein,1,0.999,8,19,19,19,13,6,13,6,13,6,1138389120,418116320,
sp|Q6Q415|RL36_DANRE,Q6Q415,RL36_DANRE,rpl36,105,Danio rerio,1:Experimental evidence at protein level,Large ribosomal subunit protein eL36,1,0.999,7,14,14,14,5,9,5,9,5,9,678627070,852540610,
sp|Q6Q420|RS15A_DANRE,Q6Q420,RS15A_DANRE,rps15a,130,Danio rerio,1:Experimental evidence at protein level,Small ribosomal subunit protein uS8,1,0.999,12,43,43,43,17,26,17,26,17,26,2199188220,2651043330,
sp|Q6Q7X9|KLH31_DANRE,Q6Q7X9,KLH31_DANRE,klhl31,635,Danio rerio,2:Experimental evidence at transcript level,Kelch-like protein 31,1,0.999,27,135,135,135,75,60,75,60,75,60,9904351200,5354810900,
sp|Q6QA33|DH12B_DANRE,Q6QA33,DH12B_DANRE,hsd17b12b,311,Danio rerio,2:Experimental evidence at transcript level,Very-long-chain 3-oxoacyl-CoA reductase-B,1,0.9988,8,8,6,24,4,4,3,3,12,12,282520320,209234704,
sp|Q6R005|DLG4_DANRE,Q6R005,DLG4_DANRE,dlg4,801,Danio rerio,2:Experimental evidence at transcript level,Disks large homolog 4,1,0.999,18,16,16,50,9,7,9,7,29,21,207614080,105892704,
sp|Q6RVD7|SX21B_DANRE,Q6RVD7,SX21B_DANRE,sox21b,245,Danio rerio,2:Experimental evidence at transcript level,Transcription factor Sox-21-B,0.675,0.9584,1,2,0,2,1,1,0,0,1,1,87552200,53319456,
sp|Q6TEL0|MTMR8_DANRE,Q6TEL0,MTMR8_DANRE,mtmr8,632,Danio rerio,2:Experimental evidence at transcript level,"Phosphatidylinositol-3,5-bisphosphate 3-phosphatase MTMR8",0.6534,0.9847,1,2,2,2,1,1,1,1,1,1,155994736,113777088,
sp|Q6TEL1|RA21A_DANRE,Q6TEL1,RA21A_DANRE,rad21a,643,Danio rerio,1:Experimental evidence at protein level,Double-strand-break repair protein rad21 homolog A,1,0.999,9,19,19,19,8,11,8,11,8,11,356737856,433514176,
sp|Q6TEN1|RAP1B_DANRE,Q6TEN1,RAP1B_DANRE,rap1b,184,Danio rerio,2:Experimental evidence at transcript level,Ras-related protein Rap-1b,1,0.999,13,102,102,102,54,48,54,48,54,48,16291136500,14022648800,
sp|Q6TEN6|WDR91_DANRE,Q6TEN6,WDR91_DANRE,wdr91,724,Danio rerio,1:Experimental evidence at protein level,WD repeat-containing protein 91,1,0.999,10,21,21,21,13,8,13,8,13,8,460103840,195599280,
sp|Q6TEP1|F91A1_DANRE,Q6TEP1,F91A1_DANRE,fam91a1,831,Danio rerio,2:Experimental evidence at transcript level,Protein FAM91A1,1,0.999,12,22,22,22,13,9,13,9,13,9,1692056700,670070340,
sp|Q6TEQ0|EEPD1_DANRE,Q6TEQ0,EEPD1_DANRE,eepd1,550,Danio rerio,2:Experimental evidence at transcript level,Endonuclease/exonuclease/phosphatase family domain-containing protein 1,0.9336,0.9972,2,3,3,3,1,2,1,2,1,2,26155180,54208748,
sp|Q6TGS6|SYYC_DANRE,Q6TGS6,SYYC_DANRE,yars1,529,Danio rerio,2:Experimental evidence at transcript level,"Tyrosine--tRNA ligase, cytoplasmic",1,0.999,21,53,53,53,30,23,30,23,30,23,7089326600,5519889400,
sp|Q6TGU2|SEH1_DANRE,Q6TGU2,SEH1_DANRE,seh1l,364,Danio rerio,2:Experimental evidence at transcript level,Nucleoporin SEH1,1,0.999,16,35,35,35,21,14,21,14,21,14,4345495000,1661253630,
sp|Q6TGV7|ABRAL_DANRE,Q6TGV7,ABRAL_DANRE,abracl,81,Danio rerio,3:Protein inferred from homology,Costars family protein ABRACL,0.959,0.9987,1,2,2,2,1,1,1,1,1,1,38788016,26857184,
sp|Q6TGW5|OSTF1_DANRE,Q6TGW5,OSTF1_DANRE,ostf1,214,Danio rerio,2:Experimental evidence at transcript level,Osteoclast-stimulating factor 1,1,0.999,12,29,29,29,22,7,22,7,22,7,2528973310,808420290,
sp|Q6TGY8|EMC2_DANRE,Q6TGY8,EMC2_DANRE,emc2,297,Danio rerio,2:Experimental evidence at transcript level,ER membrane protein complex subunit 2,1,0.999,11,25,25,25,14,11,14,11,14,11,1083494660,764478080,
sp|Q6TGZ5|HPPD_DANRE,Q6TGZ5,HPPD_DANRE,hpd,397,Danio rerio,2:Experimental evidence at transcript level,4-hydroxyphenylpyruvate dioxygenase,1,0.999,28,143,143,143,79,64,79,64,79,64,11721311200,8026730500,
sp|Q6TH01|C10_DANRE,Q6TH01,C10_DANRE,si:dkey-29f10.1,122,Danio rerio,2:Experimental evidence at transcript level,Protein C10,0.9663,0.999,1,1,1,1,1,0,1,0,1,0,59331440,0,
sp|Q6TH15|EIF3D_DANRE,Q6TH15,EIF3D_DANRE,eif3d,552,Danio rerio,2:Experimental evidence at transcript level,Eukaryotic translation initiation factor 3 subunit D,1,0.999,35,102,102,102,59,43,59,43,59,43,8670492700,5620918800,
sp|Q6TH22|DDI2_DANRE,Q6TH22,DDI2_DANRE,ddi2,411,Danio rerio,2:Experimental evidence at transcript level,Protein DDI1 homolog 2,1,0.999,11,46,46,46,26,20,26,20,26,20,1883366660,1520827140,
sp|Q6TH47|STBPA_DANRE,Q6TH47,STBPA_DANRE,stambpa,418,Danio rerio,2:Experimental evidence at transcript level,STAM-binding protein-like A,1,0.9989,6,11,11,11,7,4,7,4,7,4,311892352,190097040,
sp|Q6TLE4|EMC5_DANRE,Q6TLE4,EMC5_DANRE,mmgt1,130,Danio rerio,2:Experimental evidence at transcript level,ER membrane protein complex subunit 5,0.9996,0.9988,2,3,3,3,2,1,2,1,2,1,71270224,45502692,
sp|Q6TLF6|RGN_DANRE,Q6TLF6,RGN_DANRE,rgn,295,Danio rerio,2:Experimental evidence at transcript level,Regucalcin,1,0.999,23,99,99,99,57,42,57,42,57,42,11012284400,6225569800,
sp|Q6TNP8|VP26A_DANRE,Q6TNP8,VP26A_DANRE,vps26a,327,Danio rerio,1:Experimental evidence at protein level,Vacuolar protein sorting-associated protein 26A,1,0.999,18,46,37,46,24,22,19,18,24,22,2650878720,1618992900,
sp|Q6TNR1|RHPN2_DANRE,Q6TNR1,RHPN2_DANRE,rhpn2,683,Danio rerio,2:Experimental evidence at transcript level,Rhophilin-2,0.989,0.9965,2,3,3,3,2,1,2,1,2,1,62040464,29345104,
sp|Q6TNS2|PK1IP_DANRE,Q6TNS2,PK1IP_DANRE,pak1ip1,368,Danio rerio,2:Experimental evidence at transcript level,p21-activated protein kinase-interacting protein 1-like,1,0.999,6,8,8,8,5,3,5,3,5,3,416620768,308074752,
sp|Q6TNS7|RABL3_DANRE,Q6TNS7,RABL3_DANRE,rabl3,233,Danio rerio,2:Experimental evidence at transcript level,Rab-like protein 3,0.9999,0.9982,1,11,11,11,6,5,6,5,6,5,2710998530,2529339140,
sp|Q6TNU3|INT10_DANRE,Q6TNU3,INT10_DANRE,ints10,715,Danio rerio,2:Experimental evidence at transcript level,Integrator complex subunit 10,0.9601,0.9988,1,2,2,2,2,0,2,0,2,0,28467092,0,
sp|Q6TNU4|FEN1A_DANRE,Q6TNU4,FEN1A_DANRE,fen1,380,Danio rerio,2:Experimental evidence at transcript level,Flap endonuclease 1,1,0.999,7,11,11,11,7,4,7,4,7,4,1210236670,510510368,
sp|Q6TV19|DICER_DANRE,Q6TV19,DICER_DANRE,dicer1,1865,Danio rerio,2:Experimental evidence at transcript level,Endoribonuclease Dicer,1,0.9988,8,11,11,11,5,6,5,6,5,6,274740320,218493152,
sp|Q6UFS5|ZN503_DANRE,Q6UFS5,ZN503_DANRE,znf503,563,Danio rerio,1:Experimental evidence at protein level,Zinc finger protein 503,0.7606,0.9861,2,3,3,3,1,2,1,2,1,2,30194920,64680896,
sp|Q6VEU3|PNO1_DANRE,Q6VEU3,PNO1_DANRE,pno1,252,Danio rerio,2:Experimental evidence at transcript level,RNA-binding protein PNO1,0.9554,0.962,3,3,3,3,1,2,1,2,1,2,19046692,58910592,
sp|Q6VN46|MYG_DANRE,Q6VN46,MYG_DANRE,mb,147,Danio rerio,2:Experimental evidence at transcript level,Myoglobin,1,0.999,16,115,115,115,58,57,58,57,58,57,21044133900,14965698600,
sp|Q6ZM19|IF6_DANRE,Q6ZM19,IF6_DANRE,eif6,245,Danio rerio,2:Experimental evidence at transcript level,Eukaryotic translation initiation factor 6,1,0.999,10,45,45,45,26,19,26,19,26,19,2842420220,2118765570,
sp|Q708S6|ASI1C_DANRE,Q708S6,ASI1C_DANRE,asic1c,529,Danio rerio,1:Experimental evidence at protein level,Acid-sensing ion channel 1C,0.7957,0.9925,1,1,1,1,1,0,1,0,1,0,1197679100,0,
sp|Q708S8|ASI1B_DANRE,Q708S8,ASI1B_DANRE,asic1b,557,Danio rerio,2:Experimental evidence at transcript level,Acid-sensing ion channel 1B,0.9364,0.998,1,2,2,2,1,1,1,1,1,1,35678644,40288956,
sp|Q71N41|GAMT_DANRE,Q71N41,GAMT_DANRE,gamt,234,Danio rerio,2:Experimental evidence at transcript level,Guanidinoacetate N-methyltransferase,1,0.999,11,104,104,104,56,48,56,48,56,48,14314567700,7983937500,
sp|Q71PD7|H2AV_DANRE,Q71PD7,H2AV_DANRE,h2az2a,128,Danio rerio,2:Experimental evidence at transcript level,Histone H2A.V,1,0.999,4,11,11,33,8,3,8,3,19,14,2714251260,1466046210,
sp|Q76LC6|RBM24_DANRE,Q76LC6,RBM24_DANRE,rbm24,230,Danio rerio,2:Experimental evidence at transcript level,RNA-binding protein 24,1,0.999,3,10,10,10,8,2,8,2,8,2,2477277440,217811520,
sp|Q7SX99|FUMH_DANRE,Q7SX99,FUMH_DANRE,fh,509,Danio rerio,2:Experimental evidence at transcript level,"Fumarate hydratase, mitochondrial",1,0.999,32,301,301,301,156,145,156,145,156,145,38427660000,23148869600,
sp|Q7SXE8|CDK9_DANRE,Q7SXE8,CDK9_DANRE,cdk9,374,Danio rerio,2:Experimental evidence at transcript level,Cyclin-dependent kinase 9,1,0.999,7,8,8,15,6,2,6,2,9,6,5556972500,80232560,
sp|Q7SXF2|UBL5_DANRE,Q7SXF2,UBL5_DANRE,ubl5,73,Danio rerio,3:Protein inferred from homology,Ubiquitin-like protein 5,1,0.999,9,25,25,25,14,11,14,11,14,11,2104037500,1629647620,
sp|Q7SXF6|CREL2_DANRE,Q7SXF6,CREL2_DANRE,creld2,341,Danio rerio,2:Experimental evidence at transcript level,Cysteine-rich with EGF-like domain protein 2,1,0.999,11,48,48,48,26,22,26,22,26,22,2534005760,2426197500,
sp|Q7SXG4|SAE2_DANRE,Q7SXG4,SAE2_DANRE,uba2,650,Danio rerio,1:Experimental evidence at protein level,SUMO-activating enzyme subunit 2,1,0.999,34,144,141,144,81,63,80,61,81,63,45170815000,31530164200,
sp|Q7SXJ6|RNF25_DANRE,Q7SXJ6,RNF25_DANRE,rnf25,513,Danio rerio,1:Experimental evidence at protein level,E3 ubiquitin-protein ligase RNF25,0.6336,0.9833,1,1,1,1,1,0,1,0,1,0,25019184,0,
sp|Q7SXK5|HUTI_DANRE,Q7SXK5,HUTI_DANRE,amdhd1,433,Danio rerio,2:Experimental evidence at transcript level,Probable imidazolonepropionase,1,0.999,10,18,18,18,11,7,11,7,11,7,744873470,412709024,
sp|Q7SXL7|FL2D_DANRE,Q7SXL7,FL2D_DANRE,wtap,423,Danio rerio,2:Experimental evidence at transcript level,Pre-mRNA-splicing regulator WTAP,0.6177,0.9822,1,1,1,1,1,0,1,0,1,0,70075152,0,
sp|Q7SXM0|HDAC8_DANRE,Q7SXM0,HDAC8_DANRE,hdac8,378,Danio rerio,2:Experimental evidence at transcript level,Histone deacetylase 8,0.9666,0.999,1,1,1,1,1,0,1,0,1,0,25356112,0,
sp|Q7SXM7|PRP31_DANRE,Q7SXM7,PRP31_DANRE,prpf31,508,Danio rerio,2:Experimental evidence at transcript level,U4/U6 small nuclear ribonucleoprotein Prp31,1,0.9988,5,17,17,17,11,6,11,6,11,6,644163070,289272032,
sp|Q7SXN4|CPEB4_DANRE,Q7SXN4,CPEB4_DANRE,cpeb4,635,Danio rerio,2:Experimental evidence at transcript level,Cytoplasmic polyadenylation element-binding protein 4,1,0.999,5,9,9,9,6,3,6,3,6,3,812816380,286565792,
sp|Q7SXN5|DNM1L_DANRE,Q7SXN5,DNM1L_DANRE,dnm1l,691,Danio rerio,2:Experimental evidence at transcript level,Dynamin-1-like protein,1,0.999,14,33,33,33,19,14,19,14,19,14,2667106820,1768306430,
sp|Q7SXP0|S22BB_DANRE,Q7SXP0,S22BB_DANRE,sec22bb,215,Danio rerio,2:Experimental evidence at transcript level,Vesicle-trafficking protein SEC22b-B,1,0.999,11,29,25,29,15,14,13,12,15,14,1467455360,813637180,
sp|Q7SXP2|ULA1_DANRE,Q7SXP2,ULA1_DANRE,nae1,533,Danio rerio,2:Experimental evidence at transcript level,NEDD8-activating enzyme E1 regulatory subunit,1,0.999,16,54,54,54,33,21,33,21,33,21,3709752580,1229673730,
sp|Q7SXP4|SRS1A_DANRE,Q7SXP4,SRS1A_DANRE,srsf1a,257,Danio rerio,2:Experimental evidence at transcript level,Serine/arginine-rich splicing factor 1A,1,0.9988,9,17,1,17,10,7,1,0,10,7,318490368,146607600,
sp|Q7SXP8|GMPAB_DANRE,Q7SXP8,GMPAB_DANRE,gmppab,422,Danio rerio,2:Experimental evidence at transcript level,Mannose-1-phosphate guanylyltransferase regulatory subunit alpha-B,0.9728,0.9973,5,2,2,10,1,1,1,1,6,4,40659164,42558196,
sp|Q7SXR1|TRBP2_DANRE,Q7SXR1,TRBP2_DANRE,tarbp2,346,Danio rerio,2:Experimental evidence at transcript level,RISC-loading complex subunit tarbp2,1,0.9989,4,4,4,4,2,2,2,2,2,2,44714252,41008988,
sp|Q7SXR3|MAEA_DANRE,Q7SXR3,MAEA_DANRE,maea,396,Danio rerio,2:Experimental evidence at transcript level,E3 ubiquitin-protein transferase MAEA,0.9967,0.9899,4,7,7,7,5,2,5,2,5,2,773443460,433207328,
sp|Q7SXS7|SETD3_DANRE,Q7SXS7,SETD3_DANRE,setd3,596,Danio rerio,2:Experimental evidence at transcript level,Actin-histidine N-methyltransferase,1,0.9989,5,9,9,9,7,2,7,2,7,2,258518528,90257072,
sp|Q7SXS8|HPF1_DANRE,Q7SXS8,HPF1_DANRE,hpf1,348,Danio rerio,2:Experimental evidence at transcript level,Histone PARylation factor 1,0.8712,0.9957,1,1,1,1,1,0,1,0,1,0,23077438,0,
sp|Q7SXT7|ZC21A_DANRE,Q7SXT7,ZC21A_DANRE,zc2hc1a,327,Danio rerio,2:Experimental evidence at transcript level,Zinc finger C2HC domain-containing protein 1A,0.7535,0.9905,2,3,3,3,1,2,1,2,1,2,24187280,40412808,
sp|Q7SXU0|EI3JA_DANRE,Q7SXU0,EI3JA_DANRE,eif3ja,249,Danio rerio,1:Experimental evidence at protein level,Eukaryotic translation initiation factor 3 subunit J-A,1,0.999,4,6,6,6,5,1,5,1,5,1,217920416,112495016,
sp|Q7SXV1|TBC23_DANRE,Q7SXV1,TBC23_DANRE,tbc1d23,680,Danio rerio,2:Experimental evidence at transcript level,TBC1 domain family member 23,1,0.999,11,18,18,18,10,8,10,8,10,8,606443580,392684640,
sp|Q7SXV9|CALUB_DANRE,Q7SXV9,CALUB_DANRE,calub,315,Danio rerio,2:Experimental evidence at transcript level,Calumenin-B,1,0.999,19,77,77,91,44,33,44,33,53,38,8593175600,4160857860,
sp|Q7SXW3|LRC40_DANRE,Q7SXW3,LRC40_DANRE,lrrc40,601,Danio rerio,2:Experimental evidence at transcript level,Leucine-rich repeat-containing protein 40,0.9934,0.9985,3,4,4,4,3,1,3,1,3,1,201373344,320976640,
sp|Q7SXW4|EMC3_DANRE,Q7SXW4,EMC3_DANRE,emc3,261,Danio rerio,2:Experimental evidence at transcript level,ER membrane protein complex subunit 3,0.9998,0.9953,3,8,8,8,3,5,3,5,3,5,203642064,194530976,
sp|Q7SXW6|ARP2A_DANRE,Q7SXW6,ARP2A_DANRE,actr2a,394,Danio rerio,2:Experimental evidence at transcript level,Actin-related protein 2-A,1,0.999,27,175,33,175,92,83,17,16,92,83,14057047000,9326956500,
sp|Q7SXX7|MB12A_DANRE,Q7SXX7,MB12A_DANRE,mvb12a,275,Danio rerio,2:Experimental evidence at transcript level,Multivesicular body subunit 12A,0.967,0.999,1,2,2,2,2,0,2,0,2,0,95035184,0,
sp|Q7SY06|HACD3_DANRE,Q7SY06,HACD3_DANRE,hacd3,359,Danio rerio,2:Experimental evidence at transcript level,Very-long-chain (3R)-3-hydroxyacyl-CoA dehydratase,1,0.999,7,11,11,11,7,4,7,4,7,4,555292480,253788736,
sp|Q7SY07|EIF1A_DANRE,Q7SY07,EIF1A_DANRE,eif1ad,172,Danio rerio,2:Experimental evidence at transcript level,Probable RNA-binding protein EIF1AD,0.8469,0.991,1,3,3,3,1,2,1,2,1,2,16048562,29064674,
sp|Q7SY23|AL4A1_DANRE,Q7SY23,AL4A1_DANRE,aldh4a1,556,Danio rerio,2:Experimental evidence at transcript level,"Delta-1-pyrroline-5-carboxylate dehydrogenase, mitochondrial",1,0.999,16,42,42,42,21,21,21,21,21,21,1227455230,2450917890,
sp|Q7SY24|KPCB_DANRE,Q7SY24,KPCB_DANRE,prkcbb,670,Danio rerio,2:Experimental evidence at transcript level,Protein kinase C beta type,1,0.999,7,13,13,13,8,5,8,5,8,5,477216032,345576256,
sp|Q7SY48|HEAT1_DANRE,Q7SY48,HEAT1_DANRE,heatr1,2159,Danio rerio,2:Experimental evidence at transcript level,HEAT repeat-containing protein 1,1,0.999,6,9,9,9,5,4,5,4,5,4,209702352,69062296,
sp|Q7SY49|CAMKV_DANRE,Q7SY49,CAMKV_DANRE,camkv,436,Danio rerio,2:Experimental evidence at transcript level,CaM kinase-like vesicle-associated protein,1,0.9989,4,7,7,7,4,3,4,3,4,3,246181120,146660848,
sp|Q7SY52|STK10_DANRE,Q7SY52,STK10_DANRE,stk10,974,Danio rerio,2:Experimental evidence at transcript level,Serine/threonine-protein kinase 10,0.9409,0.9982,2,2,2,4,1,1,1,1,2,2,80855472,56567420,
sp|Q7SY54|AT2L1_DANRE,Q7SY54,AT2L1_DANRE,etnppl,492,Danio rerio,2:Experimental evidence at transcript level,Ethanolamine-phosphate phospho-lyase,1,0.999,20,45,45,45,27,18,27,18,27,18,2319978500,1418072960,
sp|Q7SYB2|THOC1_DANRE,Q7SYB2,THOC1_DANRE,thoc1,655,Danio rerio,2:Experimental evidence at transcript level,THO complex subunit 1,1,0.999,17,38,38,38,20,18,20,18,20,18,1485148160,958796670,
sp|Q7SYC9|CTL2_DANRE,Q7SYC9,CTL2_DANRE,slc44a2,697,Danio rerio,2:Experimental evidence at transcript level,Choline transporter-like protein 2,1,0.999,9,37,37,37,21,16,21,16,21,16,3649273340,2406616320,
sp|Q7SYD5|SC31A_DANRE,Q7SYD5,SC31A_DANRE,sec31a,1254,Danio rerio,2:Experimental evidence at transcript level,Protein transport protein Sec31A,1,0.999,21,84,84,84,42,42,42,42,42,42,5542557200,7041297900,
sp|Q7SYD9|INT6_DANRE,Q7SYD9,INT6_DANRE,ints6,892,Danio rerio,2:Experimental evidence at transcript level,Integrator complex subunit 6,0.8231,0.9611,1,2,2,2,2,0,2,0,2,0,10746247,0,
sp|Q7SYE0|ATG13_DANRE,Q7SYE0,ATG13_DANRE,atg13,503,Danio rerio,2:Experimental evidence at transcript level,Autophagy-related protein 13,1,0.9989,3,4,4,4,3,1,3,1,3,1,149527056,32058254,
sp|Q7SYJ9|SPAG7_DANRE,Q7SYJ9,SPAG7_DANRE,spag7,230,Danio rerio,1:Experimental evidence at protein level,Sperm-associated antigen 7 homolog,1,0.999,7,17,17,17,8,9,8,9,8,9,876596670,632422400,
sp|Q7SYK0|CHID1_DANRE,Q7SYK0,CHID1_DANRE,chid1,391,Danio rerio,2:Experimental evidence at transcript level,Chitinase domain-containing protein 1,1,0.999,9,16,16,16,11,5,11,5,11,5,376060032,152532912,
sp|Q7SYK1|TGT_DANRE,Q7SYK1,TGT_DANRE,qtrt1,400,Danio rerio,2:Experimental evidence at transcript level,Queuine tRNA-ribosyltransferase catalytic subunit 1,0.8544,0.995,1,1,1,1,1,0,1,0,1,0,42997172,0,
sp|Q7SYK7|AATM_DANRE,Q7SYK7,AATM_DANRE,got2a,428,Danio rerio,2:Experimental evidence at transcript level,"Aspartate aminotransferase, mitochondrial",1,0.999,40,403,403,403,207,196,207,196,207,196,56860942000,40089956000,
sp|Q7SYL1|AR2BP_DANRE,Q7SYL1,AR2BP_DANRE,arl2bp,168,Danio rerio,1:Experimental evidence at protein level,ADP-ribosylation factor-like protein 2-binding protein,0.9919,0.999,2,2,2,2,2,0,2,0,2,0,35401452,0,
sp|Q7SYN4|5NT3_DANRE,Q7SYN4,5NT3_DANRE,nt5c3,286,Danio rerio,2:Experimental evidence at transcript level,Cytosolic 5'-nucleotidase 3,1,0.999,15,32,32,32,17,15,17,15,17,15,2501515780,1068272380,
sp|Q7SYN5|RXRBA_DANRE,Q7SYN5,RXRBA_DANRE,rxrba,471,Danio rerio,2:Experimental evidence at transcript level,Retinoic acid receptor RXR-beta-A,1,0.999,10,5,3,14,3,2,2,1,10,4,192434816,89198624,
sp|Q7SZC2|XPO2_DANRE,Q7SZC2,XPO2_DANRE,cse1l,971,Danio rerio,1:Experimental evidence at protein level,Exportin-2,1,0.999,33,86,86,86,47,39,47,39,47,39,4330770400,3061208060,
sp|Q7SZE3|L2GL2_DANRE,Q7SZE3,L2GL2_DANRE,llgl2,1020,Danio rerio,1:Experimental evidence at protein level,LLGL scribble cell polarity complex component 2,1,0.999,22,51,51,51,30,21,30,21,30,21,2784445700,1850752380,
sp|Q7SZE5|SC23A_DANRE,Q7SZE5,SC23A_DANRE,sec23a,765,Danio rerio,2:Experimental evidence at transcript level,Protein transport protein Sec23A,1,0.999,17,37,37,37,20,17,20,17,20,17,1569677440,1189470210,
sp|Q7SZF1|CE022_DANRE,Q7SZF1,CE022_DANRE,zgc:56556,439,Danio rerio,2:Experimental evidence at transcript level,UPF0489 protein C5orf22 homolog,1,0.999,4,13,13,13,7,6,7,6,7,6,150868832,123604504,
sp|Q7SZR5|SUMO1_DANRE,Q7SZR5,SUMO1_DANRE,sumo1,100,Danio rerio,3:Protein inferred from homology,Small ubiquitin-related modifier 1,1,0.999,10,46,42,46,25,21,23,19,25,21,4931142100,3855139580,
sp|Q7T070|RHBG_DANRE,Q7T070,RHBG_DANRE,rhbg,459,Danio rerio,2:Experimental evidence at transcript level,Ammonium transporter Rh type B,1,0.999,4,22,22,22,12,10,12,10,12,10,1180455810,997899840,
sp|Q7T163|KDISB_DANRE,Q7T163,KDISB_DANRE,kidins220b,1680,Danio rerio,1:Experimental evidence at protein level,Kinase D-interacting substrate of 220 kDa B,0.9806,0.9813,3,4,4,4,2,2,2,2,2,2,47271468,332312128,
sp|Q7T291|ADPRM_DANRE,Q7T291,ADPRM_DANRE,adprm,322,Danio rerio,1:Experimental evidence at protein level,Manganese-dependent ADP-ribose/CDP-alcohol diphosphatase,0.9599,0.9988,1,1,1,1,0,1,0,1,0,1,0,23839418,
sp|Q7T297|ARB2A_DANRE,Q7T297,ARB2A_DANRE,arb2a,415,Danio rerio,2:Experimental evidence at transcript level,Cotranscriptional regulator ARB2A homolog,1,0.999,11,14,14,14,10,4,10,4,10,4,315665312,114342832,
sp|Q7T2A5|EIF3L_DANRE,Q7T2A5,EIF3L_DANRE,eif3l,576,Danio rerio,2:Experimental evidence at transcript level,Eukaryotic translation initiation factor 3 subunit L,1,0.999,30,155,155,155,80,75,80,75,80,75,24976980000,13998074900,
sp|Q7T2B9|MTPN_DANRE,Q7T2B9,MTPN_DANRE,mtpn,118,Danio rerio,3:Protein inferred from homology,Myotrophin,1,0.999,9,79,79,79,44,35,44,35,44,35,7958975000,5785534000,
sp|Q7T312|CCD25_DANRE,Q7T312,CCD25_DANRE,ccdc25,207,Danio rerio,1:Experimental evidence at protein level,Coiled-coil domain-containing protein 25,1,0.999,10,24,24,24,16,8,16,8,16,8,1333876480,1272625020,
sp|Q7T321|KCMF1_DANRE,Q7T321,KCMF1_DANRE,kcmf1,383,Danio rerio,2:Experimental evidence at transcript level,E3 ubiquitin-protein ligase KCMF1,0.9643,0.9989,1,4,4,4,2,2,2,2,2,2,187475248,218761504,
sp|Q7T322|NAA35_DANRE,Q7T322,NAA35_DANRE,naa35,724,Danio rerio,2:Experimental evidence at transcript level,"N-alpha-acetyltransferase 35, NatC auxiliary subunit",0.9903,0.991,3,4,4,4,2,2,2,2,2,2,72247856,29943510,
sp|Q7T326|CISD2_DANRE,Q7T326,CISD2_DANRE,cisd2,135,Danio rerio,2:Experimental evidence at transcript level,CDGSH iron-sulfur domain-containing protein 2,1,0.999,7,11,11,11,6,5,6,5,6,5,507244384,260494688,
sp|Q7T339|CHMP5_DANRE,Q7T339,CHMP5_DANRE,chmp5,220,Danio rerio,2:Experimental evidence at transcript level,Charged multivesicular body protein 5,0.7697,0.9913,1,2,2,2,1,1,1,1,1,1,60258352,39752892,
sp|Q7T347|UFSP2_DANRE,Q7T347,UFSP2_DANRE,ufsp2,401,Danio rerio,2:Experimental evidence at transcript level,Ufm1-specific protease 2,1,0.999,4,6,6,6,4,2,4,2,4,2,114532392,450972960,
sp|Q7T356|143BB_DANRE,Q7T356,143BB_DANRE,ywhabb,242,Danio rerio,2:Experimental evidence at transcript level,14-3-3 protein beta/alpha-B,1,0.999,28,177,79,519,90,87,43,36,257,262,28026988500,24195895300,
sp|Q7T370|CDV3_DANRE,Q7T370,CDV3_DANRE,cdv3,236,Danio rerio,2:Experimental evidence at transcript level,Protein CDV3 homolog,0.9507,0.9826,2,3,3,3,2,1,2,1,2,1,154906528,93046376,
sp|Q7T385|VTC1A_DANRE,Q7T385,VTC1A_DANRE,atp6v1c1a,383,Danio rerio,2:Experimental evidence at transcript level,V-type proton ATPase subunit C 1-A,1,0.999,33,94,71,94,53,41,38,33,53,41,8635276300,3498328830,
sp|Q7T394|LIS1A_DANRE,Q7T394,LIS1A_DANRE,pafah1b1a,410,Danio rerio,2:Experimental evidence at transcript level,Lissencephaly-1 homolog A,1,0.999,36,189,74,189,95,94,35,39,95,94,19630018600,14313891800,
sp|Q7T3A4|RAB13_DANRE,Q7T3A4,RAB13_DANRE,rab13,200,Danio rerio,1:Experimental evidence at protein level,Ras-related protein Rab-13,1,0.9989,9,59,59,59,31,28,31,28,31,28,13279132700,8733948900,
sp|Q7T3B0|EIF3M_DANRE,Q7T3B0,EIF3M_DANRE,eif3m,375,Danio rerio,2:Experimental evidence at transcript level,Eukaryotic translation initiation factor 3 subunit M,1,0.999,14,36,36,36,19,17,19,17,19,17,1367221630,873824900,
sp|Q7T3C6|CPSF5_DANRE,Q7T3C6,CPSF5_DANRE,nudt21,228,Danio rerio,2:Experimental evidence at transcript level,Cleavage and polyadenylation specificity factor subunit 5,1,0.999,9,39,39,39,22,17,22,17,22,17,3742713860,2361311490,
sp|Q7T3C7|RT4I1_DANRE,Q7T3C7,RT4I1_DANRE,rtn4ip1,387,Danio rerio,2:Experimental evidence at transcript level,"Reticulon-4-interacting protein 1 homolog, mitochondrial",1,0.999,7,11,11,11,8,3,8,3,8,3,591091780,111042584,
sp|Q7T3E4|DBR1_DANRE,Q7T3E4,DBR1_DANRE,dbr1,568,Danio rerio,1:Experimental evidence at protein level,Lariat debranching enzyme,1,0.999,9,19,19,19,12,7,12,7,12,7,840402110,418982400,
sp|Q7T3E5|KAT3_DANRE,Q7T3E5,KAT3_DANRE,kyat3,450,Danio rerio,2:Experimental evidence at transcript level,Kynurenine--oxoglutarate transaminase 3,1,0.999,20,76,76,76,41,35,41,35,41,35,5932498900,3942820100,
sp|Q7T3E6|BMI1B_DANRE,Q7T3E6,BMI1B_DANRE,bmi1b,324,Danio rerio,2:Experimental evidence at transcript level,Polycomb complex protein BMI-1-B,0.9275,0.9977,1,1,0,1,1,0,0,0,1,0,68704488,0,sp|Q8JIR0|BMI1A_DANRE
sp|Q7T3F7|CHRD1_DANRE,Q7T3F7,CHRD1_DANRE,chordc1,341,Danio rerio,2:Experimental evidence at transcript level,Cysteine and histidine-rich domain-containing protein 1,1,0.999,12,30,30,30,15,15,15,15,15,15,1771741180,1184332420,
sp|Q7T3H1|DCTN2_DANRE,Q7T3H1,DCTN2_DANRE,dctn2,405,Danio rerio,2:Experimental evidence at transcript level,Dynactin subunit 2,1,0.999,13,28,28,28,14,14,14,14,14,14,898099520,558618430,
sp|Q7T3H9|HYI_DANRE,Q7T3H9,HYI_DANRE,hyi,276,Danio rerio,2:Experimental evidence at transcript level,Putative hydroxypyruvate isomerase,1,0.999,13,42,42,42,22,20,22,20,22,20,1843866110,1438893950,
sp|Q7ZSY6|MT2_DANRE,Q7ZSY6,MT2_DANRE,mt2,60,Danio rerio,2:Experimental evidence at transcript level,Metallothionein-2,1,0.9986,4,19,2,19,10,9,1,1,10,9,1694744700,1091450500,
sp|Q7ZT42|SND1_DANRE,Q7ZT42,SND1_DANRE,snd1,897,Danio rerio,2:Experimental evidence at transcript level,Staphylococcal nuclease domain-containing protein 1,1,0.999,71,265,265,265,143,122,143,122,143,122,26422695900,16175709200,
sp|Q7ZT82|RFX1L_DANRE,Q7ZT82,RFX1L_DANRE,rbfox1l,382,Danio rerio,1:Experimental evidence at protein level,RNA binding protein fox-1 homolog 1-like,1,0.999,11,6,6,41,2,4,2,4,18,23,204750128,234240960,
sp|Q7ZTS4|K1C18_DANRE,Q7ZTS4,K1C18_DANRE,krt18,431,Danio rerio,1:Experimental evidence at protein level,"Keratin, type I cytoskeletal 18",1,0.999,60,773,744,818,398,375,385,359,418,400,394389029000,364396675000,
sp|Q7ZTY4|RBBP7_DANRE,Q7ZTY4,RBBP7_DANRE,rbbp7,426,Danio rerio,2:Experimental evidence at transcript level,Histone-binding protein RBBP7,1,0.999,25,63,63,199,34,29,34,29,107,92,6992502300,5001779200,
sp|Q7ZU29|NUP93_DANRE,Q7ZU29,NUP93_DANRE,dye,820,Danio rerio,2:Experimental evidence at transcript level,Nuclear pore complex protein Nup93,1,0.999,17,33,33,33,19,14,19,14,19,14,1928945790,1652121730,
sp|Q7ZU42|OLA1_DANRE,Q7ZU42,OLA1_DANRE,ola1,396,Danio rerio,2:Experimental evidence at transcript level,Obg-like ATPase 1,1,0.999,25,85,85,85,49,36,49,36,49,36,6507989500,3960464900,
sp|Q7ZU80|LNPA_DANRE,Q7ZU80,LNPA_DANRE,lnpka,393,Danio rerio,2:Experimental evidence at transcript level,Endoplasmic reticulum junction formation protein lunapark-A,0.9994,0.9988,2,4,4,4,2,2,2,2,2,2,11704298,29356464,
sp|Q7ZU90|CHD1L_DANRE,Q7ZU90,CHD1L_DANRE,chd1l,1026,Danio rerio,2:Experimental evidence at transcript level,Chromodomain-helicase-DNA-binding protein 1-like,0.9573,0.9888,2,7,7,7,3,4,3,4,3,4,823017790,1259615870,
sp|Q7ZU91|ITPK1_DANRE,Q7ZU91,ITPK1_DANRE,itpk1,396,Danio rerio,2:Experimental evidence at transcript level,Inositol-tetrakisphosphate 1-kinase,0.9759,0.9897,2,2,2,2,2,0,2,0,2,0,85129008,0,
sp|Q7ZU92|PARN_DANRE,Q7ZU92,PARN_DANRE,parn,660,Danio rerio,1:Experimental evidence at protein level,Poly(A)-specific ribonuclease PARN,1,0.999,12,36,36,36,20,16,20,16,20,16,1683777150,1484413180,
sp|Q7ZU99|TERA_DANRE,Q7ZU99,TERA_DANRE,vcp,806,Danio rerio,1:Experimental evidence at protein level,Transitional endoplasmic reticulum ATPase,1,0.999,77,748,748,748,372,376,372,376,372,376,122730684000,103178789000,
sp|Q7ZUB3|TSN31_DANRE,Q7ZUB3,TSN31_DANRE,tspan31,212,Danio rerio,2:Experimental evidence at transcript level,Tetraspanin-31,0.9999,0.9981,4,9,9,9,5,4,5,4,5,4,374781664,516093696,
sp|Q7ZUC2|CAB45_DANRE,Q7ZUC2,CAB45_DANRE,sdf4,356,Danio rerio,2:Experimental evidence at transcript level,45 kDa calcium-binding protein,1,0.999,12,31,31,31,19,12,19,12,19,12,1724105860,887919620,
sp|Q7ZUC7|PGES2_DANRE,Q7ZUC7,PGES2_DANRE,ptges2,377,Danio rerio,2:Experimental evidence at transcript level,Prostaglandin E synthase 2,1,0.999,9,22,22,22,12,10,12,10,12,10,876801790,529655296,
sp|Q7ZUG0|RUXE_DANRE,Q7ZUG0,RUXE_DANRE,snrpe,92,Danio rerio,3:Protein inferred from homology,Small nuclear ribonucleoprotein E,1,0.999,2,15,15,15,6,9,6,9,6,9,1692984060,1754049660,
sp|Q7ZUG5|RS21_DANRE,Q7ZUG5,RS21_DANRE,rps21,81,Danio rerio,1:Experimental evidence at protein level,Small ribosomal subunit protein eS21,1,0.999,9,26,26,26,13,13,13,13,13,13,1852473980,1503690880,
sp|Q7ZUH1|RTRAF_DANRE,Q7ZUH1,RTRAF_DANRE,rtraf,242,Danio rerio,2:Experimental evidence at transcript level,"RNA transcription, translation and transport factor protein",1,0.999,7,16,16,16,7,9,7,9,7,9,308652416,320662848,
sp|Q7ZUH5|RM14_DANRE,Q7ZUH5,RM14_DANRE,mrpl14,141,Danio rerio,2:Experimental evidence at transcript level,Large ribosomal subunit protein uL14m,0.5798,0.968,2,3,3,3,1,2,1,2,1,2,113808264,49769344,
sp|Q7ZUK7|WAC_DANRE,Q7ZUK7,WAC_DANRE,waca,558,Danio rerio,2:Experimental evidence at transcript level,WW domain-containing adapter protein with coiled-coil,0.4907,0.9704,1,2,2,2,0,2,0,2,0,2,0,0,
sp|Q7ZUL9|MGRN1_DANRE,Q7ZUL9,MGRN1_DANRE,mgrn1,529,Danio rerio,2:Experimental evidence at transcript level,Probable E3 ubiquitin-protein ligase MGRN1,0.9512,0.9981,2,2,2,2,2,0,2,0,2,0,143776464,0,
sp|Q7ZUN8|YKT6_DANRE,Q7ZUN8,YKT6_DANRE,ykt6,198,Danio rerio,2:Experimental evidence at transcript level,Synaptobrevin homolog YKT6,1,0.999,8,23,23,23,12,11,12,11,12,11,1360851460,952137540,
sp|Q7ZUP0|AN32A_DANRE,Q7ZUP0,AN32A_DANRE,anp32a,254,Danio rerio,2:Experimental evidence at transcript level,Acidic leucine-rich nuclear phosphoprotein 32 family member A,1,0.999,17,216,216,216,110,106,110,106,110,106,46709252000,35619406000,
sp|Q7ZUQ3|STK3_DANRE,Q7ZUQ3,STK3_DANRE,stk3,492,Danio rerio,2:Experimental evidence at transcript level,Serine/threonine-protein kinase 3,1,0.999,12,23,23,23,15,8,15,8,15,8,1371812100,570093380,
sp|Q7ZUS1|VRK1_DANRE,Q7ZUS1,VRK1_DANRE,vrk1,425,Danio rerio,2:Experimental evidence at transcript level,Serine/threonine-protein kinase VRK1,0.9996,0.9962,4,7,7,7,2,5,2,5,2,5,184150464,203313440,
sp|Q7ZUV0|AN13C_DANRE,Q7ZUV0,AN13C_DANRE,ankrd13c,488,Danio rerio,2:Experimental evidence at transcript level,Ankyrin repeat domain-containing protein 13C,0.993,0.9988,2,4,4,4,1,3,1,3,1,3,70772480,69609328,
sp|Q7ZUV1|PKHF2_DANRE,Q7ZUV1,PKHF2_DANRE,plekhf2,247,Danio rerio,2:Experimental evidence at transcript level,Pleckstrin homology domain-containing family F member 2,0.9964,0.999,2,2,2,2,2,0,2,0,2,0,77745888,0,
sp|Q7ZUV7|EMSY_DANRE,Q7ZUV7,EMSY_DANRE,emsy,1173,Danio rerio,2:Experimental evidence at transcript level,BRCA2-interacting transcriptional repressor EMSY,0.8791,0.9565,3,4,4,4,2,2,2,2,2,2,209150096,31029964,
sp|Q7ZUW2|HYOU1_DANRE,Q7ZUW2,HYOU1_DANRE,hyou1,980,Danio rerio,2:Experimental evidence at transcript level,Hypoxia up-regulated protein 1,1,0.999,51,184,184,184,105,79,105,79,105,79,21033447400,12123027500,
sp|Q7ZUW6|WIPI3_DANRE,Q7ZUW6,WIPI3_DANRE,wdr45b,344,Danio rerio,2:Experimental evidence at transcript level,WD repeat domain phosphoinositide-interacting protein 3,1,0.999,5,6,6,6,5,1,5,1,5,1,148941776,227426.1,
sp|Q7ZUX1|RPC3_DANRE,Q7ZUX1,RPC3_DANRE,polr3c,539,Danio rerio,2:Experimental evidence at transcript level,DNA-directed RNA polymerase III subunit RPC3,0.9767,0.98740000000000006,2,2,2,2,2,0,2,0,2,0,79086128,0,
sp|Q7ZUX3|WIPI4_DANRE,Q7ZUX3,WIPI4_DANRE,wdr45,358,Danio rerio,2:Experimental evidence at transcript level,WD repeat domain phosphoinositide-interacting protein 4,1,0.999,10,23,23,23,11,12,11,12,11,12,644150400,501264576,
sp|Q7ZUX6|DOHH_DANRE,Q7ZUX6,DOHH_DANRE,dohh,305,Danio rerio,2:Experimental evidence at transcript level,Deoxyhypusine hydroxylase,0.9669,0.999,1,1,1,1,1,0,1,0,1,0,31777160,0,
sp|Q7ZUY3|H2AX_DANRE,Q7ZUY3,H2AX_DANRE,h2ax,142,Danio rerio,2:Experimental evidence at transcript level,Histone H2AX,1,0.999,9,111,89,111,59,52,48,41,59,52,53893095000,37140021000,
sp|Q7ZUZ0|CSN8_DANRE,Q7ZUZ0,CSN8_DANRE,cops8,191,Danio rerio,2:Experimental evidence at transcript level,COP9 signalosome complex subunit 8,1,0.999,4,10,10,10,4,6,4,6,4,6,923860930,739725700,
sp|Q7ZV00|OTU6B_DANRE,Q7ZV00,OTU6B_DANRE,otud6b,293,Danio rerio,2:Experimental evidence at transcript level,Deubiquitinase OTUD6B,1,0.9986,6,10,10,10,7,3,7,3,7,3,702612990,573909180,
sp|Q7ZV03|VP26B_DANRE,Q7ZV03,VP26B_DANRE,vps26b,331,Danio rerio,2:Experimental evidence at transcript level,Vacuolar protein sorting-associated protein 26B,1,0.999,16,29,10,38,19,10,7,3,24,14,1514075140,777599870,
sp|Q7ZV15|S22BA_DANRE,Q7ZV15,S22BA_DANRE,sec22ba,215,Danio rerio,2:Experimental evidence at transcript level,Vesicle-trafficking protein SEC22b-A,0.9873,0.9934,5,3,3,7,2,1,2,1,4,3,130580208,49329436,
sp|Q7ZV22|MTAP_DANRE,Q7ZV22,MTAP_DANRE,mtap,280,Danio rerio,2:Experimental evidence at transcript level,S-methyl-5'-thioadenosine phosphorylase,1,0.999,22,147,147,147,78,69,78,69,78,69,15512020000,11656609800,
sp|Q7ZV34|MCTS1_DANRE,Q7ZV34,MCTS1_DANRE,mcts1,181,Danio rerio,2:Experimental evidence at transcript level,Malignant T-cell-amplified sequence 1,1,0.999,6,21,21,21,10,11,10,11,10,11,1026426750,586584900,
sp|Q7ZV43|TOLIP_DANRE,Q7ZV43,TOLIP_DANRE,tollip,276,Danio rerio,2:Experimental evidence at transcript level,Toll-interacting protein,1,0.999,3,12,12,12,5,7,5,7,5,7,201286320,257832992,
sp|Q7ZV50|MAGT1_DANRE,Q7ZV50,MAGT1_DANRE,magt1,328,Danio rerio,1:Experimental evidence at protein level,Magnesium transporter protein 1,0.9662,0.999,1,2,2,2,1,1,1,1,1,1,26080986,23230706,
sp|Q7ZV55|EIF3I_DANRE,Q7ZV55,EIF3I_DANRE,eif3i,325,Danio rerio,2:Experimental evidence at transcript level,Eukaryotic translation initiation factor 3 subunit I,1,0.999,21,102,102,102,46,56,46,56,46,56,15824804900,10714308600,
sp|Q7ZV60|BCS1_DANRE,Q7ZV60,BCS1_DANRE,bcs1l,420,Danio rerio,2:Experimental evidence at transcript level,Mitochondrial chaperone BCS1,0.9988,0.9975,4,5,5,5,4,1,4,1,4,1,126388224,12245660,
sp|Q7ZV68|VPS29_DANRE,Q7ZV68,VPS29_DANRE,vps29,182,Danio rerio,2:Experimental evidence at transcript level,Vacuolar protein sorting-associated protein 29,1,0.999,16,66,66,66,38,28,38,28,38,28,8735710200,5411973100,
sp|Q7ZV80|SPF30_DANRE,Q7ZV80,SPF30_DANRE,smndc1,237,Danio rerio,2:Experimental evidence at transcript level,Survival of motor neuron-related-splicing factor 30,1,0.999,7,14,14,14,8,6,8,6,8,6,915200830,430827360,
sp|Q7ZV82|RL27_DANRE,Q7ZV82,RL27_DANRE,rpl27,136,Danio rerio,1:Experimental evidence at protein level,Large ribosomal subunit protein eL27,1,0.999,9,111,111,111,55,56,55,56,55,56,14953621500,14676752400,
sp|Q7ZV96|RL10_DANRE,Q7ZV96,RL10_DANRE,rpl10,215,Danio rerio,1:Experimental evidence at protein level,Large ribosomal subunit protein uL16,1,0.999,14,31,31,31,14,17,14,17,14,17,1133113860,2022654850,
sp|Q7ZVA0|SMU1_DANRE,Q7ZVA0,SMU1_DANRE,smu1,513,Danio rerio,2:Experimental evidence at transcript level,WD40 repeat-containing protein SMU1,1,0.999,16,37,37,37,23,14,23,14,23,14,2287872260,1726739070,
sp|Q7ZVA6|IF4A3_DANRE,Q7ZVA6,IF4A3_DANRE,eif4a3,406,Danio rerio,2:Experimental evidence at transcript level,Eukaryotic initiation factor 4A-III,1,0.999,33,155,155,155,84,71,84,71,84,71,14410578900,9409459200,
sp|Q7ZVB1|CHM1B_DANRE,Q7ZVB1,CHM1B_DANRE,chmp1b,199,Danio rerio,2:Experimental evidence at transcript level,Charged multivesicular body protein 1b,0.9999,0.9984,4,7,7,7,4,3,4,3,4,3,456193568,488235552,
sp|Q7ZVB2|A9A1A_DANRE,Q7ZVB2,A9A1A_DANRE,aldh9a1a,508,Danio rerio,2:Experimental evidence at transcript level,4-trimethylaminobutyraldehyde dehydrogenase A,1,0.999,43,393,372,393,190,203,180,192,190,203,57368068000,47270425000,
sp|Q7ZVC4|CHM4B_DANRE,Q7ZVC4,CHM4B_DANRE,chmp4b,220,Danio rerio,2:Experimental evidence at transcript level,Charged multivesicular body protein 4b,0.9999,0.999,3,2,2,4,2,0,2,0,3,1,175428640,0,
sp|Q7ZVE0|GAR1_DANRE,Q7ZVE0,GAR1_DANRE,gar1,226,Danio rerio,2:Experimental evidence at transcript level,H/ACA ribonucleoprotein complex subunit 1,0.4807,0.9693,2,1,1,3,1,0,1,0,1,2,34606720,0,
sp|Q7ZVE3|TIGRB_DANRE,Q7ZVE3,TIGRB_DANRE,tigarb,257,Danio rerio,1:Experimental evidence at protein level,"Fructose-2,6-bisphosphatase TIGAR B",0.9998,0.999,3,5,5,5,3,2,3,2,3,2,117420840,84853344,
sp|Q7ZVE6|PLGT2_DANRE,Q7ZVE6,PLGT2_DANRE,poglut2,500,Danio rerio,2:Experimental evidence at transcript level,Protein O-glucosyltransferase 2,0.9994,0.9979,4,7,7,7,6,1,6,1,6,1,196653248,36501632,
sp|Q7ZVF3|SDHA_DANRE,Q7ZVF3,SDHA_DANRE,sdha,661,Danio rerio,2:Experimental evidence at transcript level,"Succinate dehydrogenase [ubiquinone] flavoprotein subunit, mitochondrial",1,0.999,38,228,228,228,124,104,124,104,124,104,38158881000,25799432200,
sp|Q7ZVF9|ACTB2_DANRE,Q7ZVF9,ACTB2_DANRE,actbb,375,Danio rerio,1:Experimental evidence at protein level,"Actin, cytoplasmic 2",1,0.999,35,1739,55,1739,865,874,26,29,865,874,659437780000,540566880000,
sp|Q7ZVG6|SIAH1_DANRE,Q7ZVG6,SIAH1_DANRE,siah1,282,Danio rerio,2:Experimental evidence at transcript level,E3 ubiquitin-protein ligase Siah1,0.9939,0.9982,2,4,2,4,3,1,2,0,3,1,54056296,27591442,
sp|Q7ZVI7|ACTB1_DANRE,Q7ZVI7,ACTB1_DANRE,actba,375,Danio rerio,1:Experimental evidence at protein level,"Actin, cytoplasmic 1",1,0.999,35,57,57,1741,31,26,31,26,870,871,3241450750,1457117570,
sp|Q7ZVJ6|QTRT2_DANRE,Q7ZVJ6,QTRT2_DANRE,qtrt2,416,Danio rerio,2:Experimental evidence at transcript level,Queuine tRNA-ribosyltransferase accessory subunit 2,0.9963,0.999,2,4,4,4,2,2,2,2,2,2,141566144,80325456,
sp|Q7ZVK3|SIR2_DANRE,Q7ZVK3,SIR2_DANRE,sirt2,379,Danio rerio,1:Experimental evidence at protein level,NAD-dependent protein deacetylase sirtuin-2,1,0.999,7,22,22,22,13,9,13,9,13,9,712674940,336643488,
sp|Q7ZVK4|VPS36_DANRE,Q7ZVK4,VPS36_DANRE,vps36,382,Danio rerio,2:Experimental evidence at transcript level,Vacuolar protein-sorting-associated protein 36,1,0.999,9,17,17,17,12,5,12,5,12,5,399053952,132487720,
sp|Q7ZVN5|SRP54_DANRE,Q7ZVN5,SRP54_DANRE,srp54,504,Danio rerio,2:Experimental evidence at transcript level,Signal recognition particle subunit SRP54,1,0.999,13,22,22,22,13,9,13,9,13,9,863259900,622069440,
sp|Q7ZVN7|MED15_DANRE,Q7ZVN7,MED15_DANRE,med15,809,Danio rerio,2:Experimental evidence at transcript level,Mediator of RNA polymerase II transcription subunit 15,0.9997,0.9989,2,2,2,2,2,0,2,0,2,0,68683536,0,
sp|Q7ZVQ8|NS1BB_DANRE,Q7ZVQ8,NS1BB_DANRE,ivns1abpb,640,Danio rerio,2:Experimental evidence at transcript level,Influenza virus NS1A-binding protein homolog B,0.569,0.9783,3,1,1,5,1,0,1,0,3,2,313210.6,0,
sp|Q7ZVR1|WDR75_DANRE,Q7ZVR1,WDR75_DANRE,wdr75,832,Danio rerio,2:Experimental evidence at transcript level,WD repeat-containing protein 75,1,0.999,5,8,8,8,5,3,5,3,5,3,117343280,25280364,
sp|Q7ZVR6|MYNN_DANRE,Q7ZVR6,MYNN_DANRE,mynn,810,Danio rerio,2:Experimental evidence at transcript level,Myoneurin,1,0.9989,5,9,9,9,5,4,5,4,5,4,168052768,197874352,
sp|Q7ZVR8|ESRP2_DANRE,Q7ZVR8,ESRP2_DANRE,esrp2,736,Danio rerio,2:Experimental evidence at transcript level,Epithelial splicing regulatory protein 2,1,0.999,7,9,9,9,7,2,7,2,7,2,247758976,47153456,
sp|Q7ZVT5|ROGDI_DANRE,Q7ZVT5,ROGDI_DANRE,rogdi,284,Danio rerio,2:Experimental evidence at transcript level,Protein rogdi homolog,1,0.999,6,14,14,14,9,5,9,5,9,5,767354690,490050816,
sp|Q7ZVW9|ARGLB_DANRE,Q7ZVW9,ARGLB_DANRE,arglu1b,269,Danio rerio,2:Experimental evidence at transcript level,Arginine and glutamate-rich protein 1-B,0.981,0.9983,6,7,3,10,4,3,2,1,6,4,237217216,196667584,
sp|Q7ZVX6|UBA3_DANRE,Q7ZVX6,UBA3_DANRE,uba3,462,Danio rerio,2:Experimental evidence at transcript level,NEDD8-activating enzyme E1 catalytic subunit,1,0.999,23,53,53,53,36,17,36,17,36,17,2697553410,1450148740,
sp|Q7ZVY5|CISY_DANRE,Q7ZVY5,CISY_DANRE,cs,468,Danio rerio,2:Experimental evidence at transcript level,"Citrate synthase, mitochondrial",1,0.999,30,463,463,463,246,217,246,217,246,217,102499246000,59519967000,
sp|Q7ZVZ6|PREP_DANRE,Q7ZVZ6,PREP_DANRE,pitrm1,1023,Danio rerio,2:Experimental evidence at transcript level,"Presequence protease, mitochondrial",1,0.999,45,127,127,127,73,54,73,54,73,54,8462264300,5930450900,
sp|Q7ZW16|RNF41_DANRE,Q7ZW16,RNF41_DANRE,rnf41,318,Danio rerio,2:Experimental evidence at transcript level,E3 ubiquitin-protein ligase NRDP1,1,0.999,5,9,9,9,6,3,6,3,6,3,239554816,77404032,
sp|Q7ZW24|ALG11_DANRE,Q7ZW24,ALG11_DANRE,alg11,500,Danio rerio,2:Experimental evidence at transcript level,"GDP-Man:Man(3)GlcNAc(2)-PP-Dol alpha-1,2-mannosyltransferase",0.9779,0.998,2,4,4,4,2,2,2,2,2,2,213610480,212085392,
sp|Q7ZW25|CHM2A_DANRE,Q7ZW25,CHM2A_DANRE,chmp2a,220,Danio rerio,2:Experimental evidence at transcript level,Charged multivesicular body protein 2a,1,0.999,11,26,26,26,13,13,13,13,13,13,1500864900,1133350140,
sp|Q7ZW33|UTP15_DANRE,Q7ZW33,UTP15_DANRE,utp15,517,Danio rerio,2:Experimental evidence at transcript level,U3 small nucleolar RNA-associated protein 15 homolog,1,0.999,11,18,18,18,13,5,13,5,13,5,375694240,189103680,
sp|Q7ZW34|CNTN5_DANRE,Q7ZW34,CNTN5_DANRE,cntn5,1056,Danio rerio,2:Experimental evidence at transcript level,Contactin-5,0.9742,0.9809,2,3,3,3,1,2,1,2,1,2,24996916,24917562,
sp|Q7ZW38|SPS1_DANRE,Q7ZW38,SPS1_DANRE,sephs1,392,Danio rerio,1:Experimental evidence at protein level,"Selenide, water dikinase 1",1,0.999,16,96,96,96,49,47,49,47,49,47,8369492500,5929069600,
sp|Q7ZW41|RPB7_DANRE,Q7ZW41,RPB7_DANRE,polr2g,172,Danio rerio,2:Experimental evidence at transcript level,DNA-directed RNA polymerase II subunit RPB7,1,0.999,10,43,43,43,25,18,25,18,25,18,3406164990,2270913540,
sp|Q7ZW47|STAU2_DANRE,Q7ZW47,STAU2_DANRE,stau2,606,Danio rerio,2:Experimental evidence at transcript level,Double-stranded RNA-binding protein Staufen homolog 2,1,0.999,16,26,26,26,16,10,16,10,16,10,974181760,652527740,
sp|Q7ZW78|RN181_DANRE,Q7ZW78,RN181_DANRE,rnf181,156,Danio rerio,2:Experimental evidence at transcript level,E3 ubiquitin-protein ligase RNF181,1,0.999,3,10,10,10,7,3,7,3,7,3,385333664,166090384,
sp|Q7ZW86|CWC27_DANRE,Q7ZW86,CWC27_DANRE,cwc27,470,Danio rerio,2:Experimental evidence at transcript level,Spliceosome-associated protein CWC27 homolog,0.9993,0.999,4,4,4,4,4,0,4,0,4,0,140456624,0,
sp|Q7ZWA3|RBMX_DANRE,Q7ZWA3,RBMX_DANRE,rbmx,379,Danio rerio,2:Experimental evidence at transcript level,"RNA-binding motif protein, X chromosome",1,0.9988,4,7,7,7,4,3,4,3,4,3,498076608,293224896,
sp|Q7ZWB2|UBL4A_DANRE,Q7ZWB2,UBL4A_DANRE,ubl4a,157,Danio rerio,2:Experimental evidence at transcript level,Ubiquitin-like protein 4A,1,0.9985,5,7,7,7,4,3,4,3,4,3,134738272,116975296,
sp|Q7ZWC3|8ODP_DANRE,Q7ZWC3,8ODP_DANRE,nudt1,156,Danio rerio,1:Experimental evidence at protein level,Oxidized purine nucleoside triphosphate hydrolase,1,0.999,5,13,13,13,7,6,7,6,7,6,386885600,308053120,
sp|Q7ZWD4|UAP1L_DANRE,Q7ZWD4,UAP1L_DANRE,uap1l1,505,Danio rerio,2:Experimental evidence at transcript level,UDP-N-acetylhexosamine pyrophosphorylase-like protein 1,1,0.999,20,44,44,44,26,18,26,18,26,18,1449833470,942767420,
sp|Q7ZWE3|LARP7_DANRE,Q7ZWE3,LARP7_DANRE,larp7,555,Danio rerio,2:Experimental evidence at transcript level,La-related protein 7,1,0.999,6,9,9,9,5,4,5,4,5,4,518376320,397383552,
sp|Q7ZWE6|DTB1A_DANRE,Q7ZWE6,DTB1A_DANRE,dtnbp1a,362,Danio rerio,2:Experimental evidence at transcript level,Dysbindin-A,0.9636,0.9989,1,1,1,1,1,0,1,0,1,0,29755312,0,
sp|Q7ZWE9|KCY_DANRE,Q7ZWE9,KCY_DANRE,cmpk,196,Danio rerio,2:Experimental evidence at transcript level,UMP-CMP kinase,1,0.999,20,94,94,94,47,47,47,47,47,47,10125567000,6409257000,
sp|Q7ZWF0|RAE1L_DANRE,Q7ZWF0,RAE1L_DANRE,rae1,368,Danio rerio,2:Experimental evidence at transcript level,mRNA export factor,1,0.999,15,55,55,55,35,20,35,20,35,20,4271603710,2274672900,
sp|Q7ZWG9|SGMR1_DANRE,Q7ZWG9,SGMR1_DANRE,sigmar1,222,Danio rerio,2:Experimental evidence at transcript level,Sigma non-opioid intracellular receptor 1,0.9909,0.999,1,5,5,5,2,3,2,3,2,3,314257504,209834560,
sp|Q7ZWI4|GSKIP_DANRE,Q7ZWI4,GSKIP_DANRE,gskip,133,Danio rerio,2:Experimental evidence at transcript level,GSK3-beta interaction protein,0.6111,0.9817,1,2,2,2,1,1,1,1,1,1,34468848,20036238,
sp|Q7ZWJ4|RL18A_DANRE,Q7ZWJ4,RL18A_DANRE,rpl18a,176,Danio rerio,1:Experimental evidence at protein level,Large ribosomal subunit protein eL20,1,0.999,12,38,38,38,13,25,13,25,13,25,935703740,2891582980,
sp|Q7ZWJ7|RL34_DANRE,Q7ZWJ7,RL34_DANRE,rpl34,117,Danio rerio,1:Experimental evidence at protein level,Large ribosomal subunit protein eL34,1,0.9989,11,44,44,44,22,22,22,22,22,22,1263022460,1225527170,
sp|Q7ZYX1|AKTIP_DANRE,Q7ZYX1,AKTIP_DANRE,aktip,293,Danio rerio,2:Experimental evidence at transcript level,AKT-interacting protein,0.9656,0.999,1,1,1,1,1,0,1,0,1,0,626390.2,0,
sp|Q7ZYY4|FAM3C_DANRE,Q7ZYY4,FAM3C_DANRE,fam3c,227,Danio rerio,2:Experimental evidence at transcript level,Protein FAM3C,1,0.9989,5,12,12,12,9,3,9,3,9,3,422374400,169404112,
sp|Q7ZYZ6|DLGP1_DANRE,Q7ZYZ6,DLGP1_DANRE,dlgap1,999,Danio rerio,3:Protein inferred from homology,Disks large-associated protein 1,0.9614,0.9925,3,3,3,3,1,2,1,2,1,2,51157224,60964336,
sp|Q7ZZ03|FUCM_DANRE,Q7ZZ03,FUCM_DANRE,fuom,153,Danio rerio,2:Experimental evidence at transcript level,Fucose mutarotase,1,0.9989,5,6,6,6,4,2,4,2,4,2,246855936,117586368,
sp|Q802D3|XPO4_DANRE,Q802D3,XPO4_DANRE,xpo4,1150,Danio rerio,2:Experimental evidence at transcript level,Exportin-4,0.9993,0.9987,2,4,4,4,3,1,3,1,3,1,276747808,8057904,
sp|Q802F3|SEP15_DANRE,Q802F3,SEP15_DANRE,selenof,153,Danio rerio,2:Experimental evidence at transcript level,Selenoprotein F,1,0.999,7,24,24,24,14,10,14,10,14,10,1967974400,911166780,
sp|Q802G7|SELM_DANRE,Q802G7,SELM_DANRE,Selenom,151,Danio rerio,2:Experimental evidence at transcript level,Selenoprotein M,0.9843,0.999,2,4,4,4,2,2,2,2,2,2,117695920,101723120,
sp|Q802U2|MIOS_DANRE,Q802U2,MIOS_DANRE,mios,876,Danio rerio,2:Experimental evidence at transcript level,GATOR2 complex protein MIOS,0.9998,0.9989,3,8,8,8,4,4,4,4,4,4,94918104,66463444,
sp|Q802W2|A9A1B_DANRE,Q802W2,A9A1B_DANRE,aldh9a1b,518,Danio rerio,2:Experimental evidence at transcript level,4-trimethylaminobutyraldehyde dehydrogenase B,0.9992,0.9875,4,2,2,23,1,1,1,1,11,12,113777960,109336384,
sp|Q802W4|NOL10_DANRE,Q802W4,NOL10_DANRE,nol10,722,Danio rerio,2:Experimental evidence at transcript level,Nucleolar protein 10,0.9997,0.999,4,4,4,4,4,0,4,0,4,0,137017792,0,
sp|Q803A6|MCMBP_DANRE,Q803A6,MCMBP_DANRE,mcmbp,631,Danio rerio,2:Experimental evidence at transcript level,Mini-chromosome maintenance complex-binding protein,1,0.999,10,13,13,13,9,4,9,4,9,4,407798080,227329920,
sp|Q803A7|SPCS_DANRE,Q803A7,SPCS_DANRE,sepsecs,490,Danio rerio,2:Experimental evidence at transcript level,O-phosphoseryl-tRNA(Sec) selenium transferase,1,0.999,10,17,17,17,10,7,10,7,10,7,483144704,222581248,
sp|Q803C3|HDAC3_DANRE,Q803C3,HDAC3_DANRE,hdac3,428,Danio rerio,2:Experimental evidence at transcript level,Histone deacetylase 3,0.967,0.999,1,1,1,1,1,0,1,0,1,0,22028264,0,
sp|Q803D2|LIS1B_DANRE,Q803D2,LIS1B_DANRE,pafah1b1b,410,Danio rerio,2:Experimental evidence at transcript level,Lissencephaly-1 homolog B,1,0.999,35,41,41,156,23,18,23,18,83,73,4201883650,2677556990,
sp|Q803E1|NCBP3_DANRE,Q803E1,NCBP3_DANRE,ncbp3,694,Danio rerio,2:Experimental evidence at transcript level,Nuclear cap-binding protein subunit 3,1,0.9988,5,7,7,7,4,3,4,3,4,3,242735568,515464224,
sp|Q803F5|APMAP_DANRE,Q803F5,APMAP_DANRE,apmap,415,Danio rerio,2:Experimental evidence at transcript level,Adipocyte plasma membrane-associated protein,1,0.999,17,62,62,62,32,30,32,30,32,30,3867553790,3075331330,
sp|Q803F6|RSSA_DANRE,Q803F6,RSSA_DANRE,rpsa,308,Danio rerio,1:Experimental evidence at protein level,Small ribosomal subunit protein uS2,1,0.999,12,63,63,63,29,34,29,34,29,34,3872477700,3878624510,
sp|Q803G5|SAM5A_DANRE,Q803G5,SAM5A_DANRE,samm50a,469,Danio rerio,2:Experimental evidence at transcript level,Sorting and assembly machinery component 50 homolog A,1,0.999,23,70,64,70,40,30,36,28,40,30,3784023300,2468359680,
sp|Q803H0|CG025_DANRE,Q803H0,CG025_DANRE,zgc:55781,427,Danio rerio,2:Experimental evidence at transcript level,UPF0415 protein C7orf25 homolog,0.9568,0.9857,3,4,4,4,3,1,3,1,3,1,37584452,10006394,
sp|Q803I2|ERGI3_DANRE,Q803I2,ERGI3_DANRE,ergic3,383,Danio rerio,2:Experimental evidence at transcript level,Endoplasmic reticulum-Golgi intermediate compartment protein 3,1,0.999,8,17,17,17,11,6,11,6,11,6,601999490,332710624,
sp|Q803I4|RING2_DANRE,Q803I4,RING2_DANRE,rnf2,336,Danio rerio,2:Experimental evidence at transcript level,E3 ubiquitin-protein ligase RING2,1,0.999,4,9,9,9,4,5,4,5,4,5,365832256,124192808,
sp|Q803I8|SYVN1_DANRE,Q803I8,SYVN1_DANRE,syvn1,625,Danio rerio,2:Experimental evidence at transcript level,E3 ubiquitin-protein ligase synoviolin,0.931,0.9978,2,2,2,2,1,1,1,1,1,1,0,30466954,
sp|Q803J8|ZC3HF_DANRE,Q803J8,ZC3HF_DANRE,zc3h15,433,Danio rerio,2:Experimental evidence at transcript level,Zinc finger CCCH domain-containing protein 15,1,0.9986,6,15,15,15,9,6,9,6,9,6,788985220,496337440,
sp|Q803K4|SETD6_DANRE,Q803K4,SETD6_DANRE,setd6,460,Danio rerio,2:Experimental evidence at transcript level,N-lysine methyltransferase setd6,0.971,0.9851,2,4,4,4,2,2,2,2,2,2,163561888,22019788,
sp|Q803L0|LN28A_DANRE,Q803L0,LN28A_DANRE,lin28a,202,Danio rerio,1:Experimental evidence at protein level,Protein lin-28 homolog A,1,0.999,5,10,10,10,8,2,8,2,8,2,152569232,1656875260,
sp|Q803M3|TEX10_DANRE,Q803M3,TEX10_DANRE,tex10,933,Danio rerio,2:Experimental evidence at transcript level,Testis-expressed protein 10 homolog,0.9607,0.9988,1,1,1,1,1,0,1,0,1,0,33666696,0,
sp|Q803M5|SAAL1_DANRE,Q803M5,SAAL1_DANRE,saal1,469,Danio rerio,2:Experimental evidence at transcript level,Protein saal1,1,0.9971,4,8,8,8,5,3,5,3,5,3,157873552,75459232,
sp|Q803P1|EI3JB_DANRE,Q803P1,EI3JB_DANRE,eif3jb,263,Danio rerio,2:Experimental evidence at transcript level,Eukaryotic translation initiation factor 3 subunit J-B,1,0.999,4,8,8,8,5,3,5,3,5,3,545093630,364097088,
sp|Q803R2|CCZ1_DANRE,Q803R2,CCZ1_DANRE,ccz1,480,Danio rerio,2:Experimental evidence at transcript level,Vacuolar fusion protein CCZ1 homolog,1,0.999,6,9,9,9,6,3,6,3,6,3,251974944,115988304,
sp|Q803R5|CMTR1_DANRE,Q803R5,CMTR1_DANRE,cmtr1,829,Danio rerio,2:Experimental evidence at transcript level,Cap-specific mRNA (nucleoside-2'-O-)-methyltransferase 1,1,0.9956,6,8,8,8,3,5,3,5,3,5,120952560,147089120,
sp|Q803S3|MEMO1_DANRE,Q803S3,MEMO1_DANRE,memo1,297,Danio rerio,2:Experimental evidence at transcript level,Protein MEMO1,1,0.999,17,44,44,44,26,18,26,18,26,18,3959685630,2107718910,
sp|Q803V5|LST8_DANRE,Q803V5,LST8_DANRE,mlst8,326,Danio rerio,2:Experimental evidence at transcript level,Target of rapamycin complex subunit lst8,1,0.999,6,11,11,11,5,6,5,6,5,6,470543328,271289632,
sp|Q803W1|SCRN3_DANRE,Q803W1,SCRN3_DANRE,scrn3,417,Danio rerio,2:Experimental evidence at transcript level,Secernin-3,1,0.999,15,44,44,44,25,19,25,19,25,19,2033742850,1050565120,
sp|Q803X4|DCA13_DANRE,Q803X4,DCA13_DANRE,dcaf13,445,Danio rerio,2:Experimental evidence at transcript level,DDB1- and CUL4-associated factor 13,0.9997,0.9989,3,3,3,3,3,0,3,0,3,0,35253252,0,
sp|Q803Y4|UFM1_DANRE,Q803Y4,UFM1_DANRE,ufm1,90,Danio rerio,3:Protein inferred from homology,Ubiquitin-fold modifier 1,1,0.999,4,25,25,25,11,14,11,14,11,14,2605703680,2056478210,
sp|Q804W2|PRV7_DANRE,Q804W2,PRV7_DANRE,pvalb7,109,Danio rerio,3:Protein inferred from homology,Parvalbumin-7,1,0.999,16,153,153,153,81,72,81,72,81,72,32970879000,30598422500,
sp|Q8AWW7|RUVB1_DANRE,Q8AWW7,RUVB1_DANRE,ruvbl1,456,Danio rerio,2:Experimental evidence at transcript level,RuvB-like 1,1,0.999,23,84,79,84,42,42,39,40,42,42,5158818300,4418836000,
sp|Q8AXB3|VGFR4_DANRE,Q8AXB3,VGFR4_DANRE,kdrl,1302,Danio rerio,1:Experimental evidence at protein level,Vascular endothelial growth factor receptor kdr-like,0.9526,0.9909,2,8,1,8,5,3,1,0,5,3,784575040,1062241410,
sp|Q8AXZ4|CNT1A_DANRE,Q8AXZ4,CNT1A_DANRE,cntn1a,1032,Danio rerio,2:Experimental evidence at transcript level,Contactin-1a,1,0.999,14,23,23,23,14,9,14,9,14,9,922599940,409099136,
sp|Q8AYB8|HOP_DANRE,Q8AYB8,HOP_DANRE,hopx,77,Danio rerio,3:Protein inferred from homology,Homeodomain-only protein,0.9875,0.9956,3,3,3,3,3,0,3,0,3,0,144044720,0,
sp|Q8AYN0|OPSR2_DANRE,Q8AYN0,OPSR2_DANRE,opn1lw2,356,Danio rerio,1:Experimental evidence at protein level,Red-sensitive opsin-2,1,0.999,6,33,1,33,15,18,0,1,15,18,2138332800,1506071550,
sp|Q8JFV8|VAT1_DANRE,Q8JFV8,VAT1_DANRE,vat1,484,Danio rerio,2:Experimental evidence at transcript level,Synaptic vesicle membrane protein VAT-1 homolog,1,0.999,25,145,145,145,76,69,76,69,76,69,14177534000,11002381300,
sp|Q8JG38|FGFR2_DANRE,Q8JG38,FGFR2_DANRE,fgfr2,817,Danio rerio,1:Experimental evidence at protein level,Fibroblast growth factor receptor 2,1,0.999,5,6,5,13,4,2,3,2,7,6,148696480,54217432,
sp|Q8JGR4|RL24_DANRE,Q8JGR4,RL24_DANRE,rpl24,157,Danio rerio,2:Experimental evidence at transcript level,Large ribosomal subunit protein eL24,1,0.999,8,46,46,46,22,24,22,24,22,24,2332050690,1896711680,
sp|Q8JGR6|NCBP2_DANRE,Q8JGR6,NCBP2_DANRE,ncbp2,155,Danio rerio,2:Experimental evidence at transcript level,Nuclear cap-binding protein subunit 2,1,0.999,7,12,12,12,6,6,6,6,6,6,748282180,398779552,
sp|Q8JGR7|INT7_DANRE,Q8JGR7,INT7_DANRE,ints7,964,Danio rerio,2:Experimental evidence at transcript level,Integrator complex subunit 7,0.9999,0.9987,3,5,5,5,5,0,5,0,5,0,89729104,0,
sp|Q8JGS0|RU1C_DANRE,Q8JGS0,RU1C_DANRE,snrpc,159,Danio rerio,2:Experimental evidence at transcript level,U1 small nuclear ribonucleoprotein C,1,0.999,3,14,14,14,7,7,7,7,7,7,944573820,551938110,
sp|Q8JGS9|RS18_DANRE,Q8JGS9,RS18_DANRE,rps18,152,Danio rerio,1:Experimental evidence at protein level,Small ribosomal subunit protein uS13,1,0.999,16,53,53,53,25,28,25,28,25,28,3430214140,3972915200,
sp|Q8JGW0|TSP4B_DANRE,Q8JGW0,TSP4B_DANRE,thbs4b,949,Danio rerio,2:Experimental evidence at transcript level,Thrombospondin-4-B,1,0.999,18,44,40,44,27,17,25,15,27,17,2468382980,9335914500,
sp|Q8JH47|CDK8_DANRE,Q8JH47,CDK8_DANRE,cdk8,464,Danio rerio,2:Experimental evidence at transcript level,Cyclin-dependent kinase 8,1,0.9949,6,8,8,8,5,3,5,3,5,3,91687376,687553340,
sp|Q8JH70|ALDCB_DANRE,Q8JH70,ALDCB_DANRE,aldocb,363,Danio rerio,2:Experimental evidence at transcript level,Fructose-bisphosphate aldolase C-B,1,0.999,41,695,486,695,352,343,248,238,352,343,198682608000,132269474000,
sp|Q8JH71|ALDOB_DANRE,Q8JH71,ALDOB_DANRE,aldob,364,Danio rerio,2:Experimental evidence at transcript level,Fructose-bisphosphate aldolase B,1,0.999,40,618,537,661,332,286,289,248,352,309,182942646000,140625936000,
sp|Q8JHF4|PAL1A_DANRE,Q8JHF4,PAL1A_DANRE,pals1a,677,Danio rerio,1:Experimental evidence at protein level,Protein PALS1,1,0.999,4,6,6,6,4,2,4,2,4,2,158026736,123016440,
sp|Q8JHJ1|RL35_DANRE,Q8JHJ1,RL35_DANRE,rpl35,123,Danio rerio,1:Experimental evidence at protein level,Large ribosomal subunit protein uL29,1,0.9947,5,15,15,15,7,8,7,8,7,8,641064510,664226430,
sp|Q8JHV6|LAMB4_DANRE,Q8JHV6,LAMB4_DANRE,lamb4,1827,Danio rerio,2:Experimental evidence at transcript level,Laminin subunit beta-4,1,0.999,8,11,11,11,8,3,8,3,8,3,329182848,94913312,
sp|Q8JHW2|TSP3A_DANRE,Q8JHW2,TSP3A_DANRE,thbs3a,962,Danio rerio,2:Experimental evidence at transcript level,Thrombospondin-3a,0.9731,0.9907,3,3,3,5,3,0,3,0,4,1,180764176,0,
sp|Q8JIU7|NACA_DANRE,Q8JIU7,NACA_DANRE,naca,215,Danio rerio,1:Experimental evidence at protein level,Nascent polypeptide-associated complex subunit alpha,1,0.999,7,115,115,115,55,60,55,60,55,60,16298095600,14861294600,
sp|Q8JIY8|MK67I_DANRE,Q8JIY8,MK67I_DANRE,nifk,269,Danio rerio,2:Experimental evidence at transcript level,MKI67 FHA domain-interacting nucleolar phosphoprotein,0.967,0.999,1,2,2,2,1,1,1,1,1,1,71317320,50079052,
sp|Q8QFX6|NRP1A_DANRE,Q8QFX6,NRP1A_DANRE,nrp1a,923,Danio rerio,2:Experimental evidence at transcript level,Neuropilin-1a,1,0.999,11,16,16,16,12,4,12,4,12,4,766505410,311736896,
sp|Q8UUR3|CYGB1_DANRE,Q8UUR3,CYGB1_DANRE,cygb1,174,Danio rerio,2:Experimental evidence at transcript level,Cytoglobin-1,1,0.999,7,30,30,30,16,14,16,14,16,14,1051116290,801355260,
sp|Q8UVJ6|VANG2_DANRE,Q8UVJ6,VANG2_DANRE,vangl2,526,Danio rerio,1:Experimental evidence at protein level,Vang-like protein 2,0.9998,0.9987,2,2,2,2,2,0,2,0,2,0,57112068,0,
sp|Q8UVK2|SPT6H_DANRE,Q8UVK2,SPT6H_DANRE,supt6h,1726,Danio rerio,1:Experimental evidence at protein level,Transcription elongation factor SPT6,1,0.999,47,106,106,106,60,46,60,46,60,46,4175561470,2230043390,
sp|Q8UVX0|PIWL1_DANRE,Q8UVX0,PIWL1_DANRE,piwil1,858,Danio rerio,1:Experimental evidence at protein level,Piwi-like protein 1,1,0.999,33,55,55,55,37,18,37,18,37,18,2800129280,1115691780,
sp|Q90275|CADH2_DANRE,Q90275,CADH2_DANRE,cdh2,893,Danio rerio,1:Experimental evidence at protein level,Cadherin-2,1,0.999,18,46,46,46,28,18,28,18,28,18,3197303300,1810957570,
sp|Q90460|C166A_DANRE,Q90460,C166A_DANRE,alcama,564,Danio rerio,1:Experimental evidence at protein level,CD166 antigen homolog A,1,0.999,28,119,119,119,65,54,65,54,65,54,12318352400,9444530200,
sp|Q90473|HSP7C_DANRE,Q90473,HSP7C_DANRE,hspa8,649,Danio rerio,2:Experimental evidence at transcript level,Heat shock cognate 71 kDa protein,1,0.999,53,1509,1509,1509,771,738,771,738,771,738,371810140000,260507058000,
sp|Q90474|H90A1_DANRE,Q90474,H90A1_DANRE,hsp90a.1,725,Danio rerio,1:Experimental evidence at protein level,Heat shock protein HSP 90-alpha 1,1,0.999,57,306,306,525,165,141,165,141,274,251,39585165000,26831976400,
sp|Q90478|L1CA1_DANRE,Q90478,L1CA1_DANRE,nadl1.1,1197,Danio rerio,2:Experimental evidence at transcript level,Neural cell adhesion molecule L1.1 (Fragment),1,0.999,15,30,30,30,15,15,15,15,15,15,1512586370,1106326140,
sp|Q90479|L1CA2_DANRE,Q90479,L1CA2_DANRE,nadl1.2,216,Danio rerio,2:Experimental evidence at transcript level,Neural cell adhesion molecule L1.2 (Fragment),0.9979,0.992,3,5,5,5,2,3,2,3,2,3,25676250,101784944,
sp|Q90486|HBB1_DANRE,Q90486,HBB1_DANRE,ba1,148,Danio rerio,1:Experimental evidence at protein level,Hemoglobin subunit beta-1,1,0.9985,2,65,35,65,31,34,18,17,31,34,42092270000,37447926000,
sp|Q90487|HBA_DANRE,Q90487,HBA_DANRE,hbaa1,143,Danio rerio,2:Experimental evidence at transcript level,Hemoglobin subunit alpha,0.9999,0.9981,3,25,25,25,12,13,12,13,12,13,2263500290,5191972900,
sp|Q90W33|HIC2_DANRE,Q90W33,HIC2_DANRE,hic2,560,Danio rerio,2:Experimental evidence at transcript level,Hypermethylated in cancer 2 protein,0.9493,0.9984,1,1,1,1,1,0,1,0,1,0,19478162,0,
sp|Q90X38|GPKOW_DANRE,Q90X38,GPKOW_DANRE,gpkow,506,Danio rerio,2:Experimental evidence at transcript level,G-patch domain and KOW motifs-containing protein,0.9535,0.9912,3,3,3,3,1,2,1,2,1,2,145078880,114773808,
sp|Q90X44|NRF1_DANRE,Q90X44,NRF1_DANRE,nrf1,514,Danio rerio,2:Experimental evidence at transcript level,Nuclear respiratory factor 1,0.9983,0.9963,3,4,4,4,3,1,3,1,3,1,101890352,46509664,
sp|Q90XF2|KPCI_DANRE,Q90XF2,KPCI_DANRE,prkci,588,Danio rerio,2:Experimental evidence at transcript level,Protein kinase C iota type,1,0.999,9,15,15,15,9,6,9,6,9,6,736921340,444426560,
sp|Q90XG0|TPISB_DANRE,Q90XG0,TPISB_DANRE,tpi1b,248,Danio rerio,2:Experimental evidence at transcript level,Triosephosphate isomerase B,1,0.999,27,674,446,674,349,325,228,218,349,325,280394531000,191273894000,
sp|Q90Y50|CXAR_DANRE,Q90Y50,CXAR_DANRE,cxadr,372,Danio rerio,2:Experimental evidence at transcript level,Coxsackievirus and adenovirus receptor homolog,1,0.999,12,65,65,65,35,30,35,30,35,30,4478673400,2743237380,
sp|Q90YJ2|NGB_DANRE,Q90YJ2,NGB_DANRE,ngb,159,Danio rerio,1:Experimental evidence at protein level,Neuroglobin,0.5128,0.9729,1,2,2,2,1,1,1,1,1,1,187146512,128246208,
sp|Q90YL4|S61A2_DANRE,Q90YL4,S61A2_DANRE,sec61al2,476,Danio rerio,2:Experimental evidence at transcript level,Protein transport protein Sec61 subunit alpha-like 2,1,0.9989,6,16,0,16,8,8,0,0,8,8,493609024,441117568,sp|Q90ZM2|S61A1_DANRE
sp|Q90YM8|CYFP1_DANRE,Q90YM8,CYFP1_DANRE,cyfip1,1253,Danio rerio,2:Experimental evidence at transcript level,Cytoplasmic FMR1-interacting protein 1 homolog,1,0.999,16,23,23,23,14,9,14,9,14,9,778007420,356827072,
sp|Q90Z08|U119B_DANRE,Q90Z08,U119B_DANRE,unc119b,243,Danio rerio,1:Experimental evidence at protein level,Protein unc-119 homolog B,1,0.999,6,9,9,9,6,3,6,3,6,3,247606720,152070688,
sp|Q90Z10|RL13_DANRE,Q90Z10,RL13_DANRE,rpl13,211,Danio rerio,1:Experimental evidence at protein level,Large ribosomal subunit protein eL13,1,0.999,17,54,54,54,24,30,24,30,24,30,4103835390,3447714050,
sp|Q90Z37|CADH1_DANRE,Q90Z37,CADH1_DANRE,cdh1,864,Danio rerio,1:Experimental evidence at protein level,Cadherin-1,1,0.999,29,111,111,111,63,48,63,48,63,48,8631492600,5149937700,
sp|Q90ZY6|TLK1B_DANRE,Q90ZY6,TLK1B_DANRE,tlk1b,756,Danio rerio,2:Experimental evidence at transcript level,Serine/threonine-protein kinase tousled-like 1-B,0.9281,0.9902,3,2,1,6,1,1,1,0,3,3,166817280,13875388,
sp|Q91398|CSK2B_DANRE,Q91398,CSK2B_DANRE,csnk2b,215,Danio rerio,2:Experimental evidence at transcript level,Casein kinase II subunit beta,1,0.999,6,12,12,12,8,4,8,4,8,4,1020369410,415179520,
sp|Q92005|EF1A_DANRE,Q92005,EF1A_DANRE,eef1a,462,Danio rerio,2:Experimental evidence at transcript level,Elongation factor 1-alpha,1,0.999,33,429,429,429,215,214,215,214,215,214,146780750000,128422486000,
sp|Q92008|SHH_DANRE,Q92008,SHH_DANRE,shha,418,Danio rerio,1:Experimental evidence at protein level,Sonic hedgehog protein,1,0.999,5,8,8,8,4,4,4,4,4,4,263915840,128208328,
sp|Q92047|PIMT_DANRE,Q92047,PIMT_DANRE,pcmt,228,Danio rerio,2:Experimental evidence at transcript level,Protein-L-isoaspartate(D-aspartate) O-methyltransferase,1,0.999,13,36,36,36,22,14,22,14,22,14,2221984000,1668018050,
sp|Q92051|CAHZ_DANRE,Q92051,CAHZ_DANRE,cahz,260,Danio rerio,1:Experimental evidence at protein level,Carbonic anhydrase,1,0.999,15,125,125,125,70,55,70,55,70,55,19262685200,12396736500,
sp|Q98874|ERH_DANRE,Q98874,ERH_DANRE,erh,104,Danio rerio,3:Protein inferred from homology,Enhancer of rudimentary homolog,1,0.999,5,22,22,22,13,9,13,9,13,9,3044153600,2548333820,
sp|Q98880|ACHA_DANRE,Q98880,ACHA_DANRE,chrna1,456,Danio rerio,2:Experimental evidence at transcript level,Acetylcholine receptor subunit alpha,1,0.999,3,8,8,8,4,4,4,4,4,4,457947840,355686208,
sp|Q98SP7|BBS2_DANRE,Q98SP7,BBS2_DANRE,bbs2,715,Danio rerio,2:Experimental evidence at transcript level,BBSome complex member BBS2,0.9589,0.9987,1,1,1,1,1,0,1,0,1,0,30888544,0,
sp|Q98SV1|SELPA_DANRE,Q98SV1,SELPA_DANRE,sepp1a,367,Danio rerio,1:Experimental evidence at protein level,Selenoprotein Pa,1,0.999,7,12,12,12,7,5,7,5,7,5,834435070,242716128,
sp|Q98TZ8|FLOT2_DANRE,Q98TZ8,FLOT2_DANRE,flot2a,428,Danio rerio,2:Experimental evidence at transcript level,Flotillin-2a,1,0.999,22,90,90,90,51,39,51,39,51,39,15379696600,7383520300,
sp|Q9DDE3|ACES_DANRE,Q9DDE3,ACES_DANRE,ache,634,Danio rerio,1:Experimental evidence at protein level,Acetylcholinesterase,1,0.999,17,43,43,43,27,16,27,16,27,16,2660106750,1179530880,
sp|Q9DDT5|SPT5H_DANRE,Q9DDT5,SPT5H_DANRE,supt5h,1084,Danio rerio,1:Experimental evidence at protein level,Transcription elongation factor SPT5,1,0.999,34,87,87,87,51,36,51,36,51,36,4369715700,3766932220,
sp|Q9DFG8|MKRN2_DANRE,Q9DFG8,MKRN2_DANRE,mkrn2,414,Danio rerio,2:Experimental evidence at transcript level,E3 ubiquitin-protein ligase makorin-2,1,0.999,6,8,8,8,6,2,6,2,6,2,194862848,11904214,
sp|Q9DFS6|IF4EA_DANRE,Q9DFS6,IF4EA_DANRE,eif4ea,215,Danio rerio,1:Experimental evidence at protein level,Eukaryotic translation initiation factor 4E-1A,1,0.999,7,18,18,18,11,7,11,7,11,7,1401857020,729290240,
sp|Q9DG12|ARNT2_DANRE,Q9DG12,ARNT2_DANRE,arnt2,737,Danio rerio,1:Experimental evidence at protein level,Aryl hydrocarbon receptor nuclear translocator 2,1,0.999,4,6,6,6,3,3,3,3,3,3,125633728,62243452,
sp|Q9DGD9|MK08_DANRE,Q9DGD9,MK08_DANRE,mapk8,384,Danio rerio,2:Experimental evidence at transcript level,Mitogen-activated protein kinase 8,1,0.999,12,30,21,30,18,12,14,7,18,12,2064293380,1540455810,
sp|Q9DGE0|MP2K6_DANRE,Q9DGE0,MP2K6_DANRE,map2k6,361,Danio rerio,1:Experimental evidence at protein level,Dual specificity mitogen-activated protein kinase kinase 6,1,0.999,6,10,10,10,6,4,6,4,6,4,383549856,250158384,
sp|Q9DGE1|MK14B_DANRE,Q9DGE1,MK14B_DANRE,mapk14b,348,Danio rerio,1:Experimental evidence at protein level,Mitogen-activated protein kinase 14B,0.9953,0.9941,7,4,4,20,2,2,2,2,10,10,165571600,65797284,
sp|Q9DGE2|MK14A_DANRE,Q9DGE2,MK14A_DANRE,mapk14a,361,Danio rerio,1:Experimental evidence at protein level,Mitogen-activated protein kinase 14A,1,0.999,9,20,13,29,13,7,9,4,17,12,1201782140,736102020,
sp|Q9DGJ3|NPC2_DANRE,Q9DGJ3,NPC2_DANRE,npc2,149,Danio rerio,2:Experimental evidence at transcript level,NPC intracellular cholesterol transporter 2,1,0.999,8,39,39,39,25,14,25,14,25,14,2711283460,1530954880,
sp|Q9DGK4|TCTP_DANRE,Q9DGK4,TCTP_DANRE,tpt1,171,Danio rerio,2:Experimental evidence at transcript level,Translationally-controlled tumor protein homolog,1,0.999,14,327,327,327,176,151,176,151,176,151,75276354000,49330311000,
sp|Q9I8L5|FA10A_DANRE,Q9I8L5,FA10A_DANRE,fabp10a,126,Danio rerio,1:Experimental evidence at protein level,"Fatty acid-binding protein 10-A, liver basic",1,0.999,13,334,334,334,159,175,159,175,159,175,71809335000,55402426000,
sp|Q9I8V0|PRV2_DANRE,Q9I8V0,PRV2_DANRE,pvalb2,109,Danio rerio,3:Protein inferred from homology,Parvalbumin-2,1,0.999,20,2318,2318,2318,1161,1157,1161,1157,1161,1157,3822298330000,3965676950000,
sp|Q9I9N0|DAP1B_DANRE,Q9I9N0,DAP1B_DANRE,dap1b,109,Danio rerio,1:Experimental evidence at protein level,Death-associated protein-like 1 homolog,0.9995,0.9979,2,5,5,5,3,2,3,2,3,2,146640640,68444704,
sp|Q9I9N1|DAP1A_DANRE,Q9I9N1,DAP1A_DANRE,dap,105,Danio rerio,1:Experimental evidence at protein level,Death-associated protein 1 homolog,0.7532,0.9905,2,2,2,2,1,1,1,1,1,1,22389218,15912330,
sp|Q9I9N5|TRADD_DANRE,Q9I9N5,TRADD_DANRE,tradd,293,Danio rerio,2:Experimental evidence at transcript level,Tumor necrosis factor receptor type 1-associated DEATH domain protein,1,0.999,6,7,7,7,6,1,6,1,6,1,447004064,91220112,
sp|Q9I9N6|ASC_DANRE,Q9I9N6,ASC_DANRE,pycard,203,Danio rerio,1:Experimental evidence at protein level,Apoptosis-associated speck-like protein containing a CARD,1,0.999,17,101,101,101,48,53,48,53,48,53,12688726000,8825801700,
sp|Q9I9P9|SMAD2_DANRE,Q9I9P9,SMAD2_DANRE,smad2,468,Danio rerio,2:Experimental evidence at transcript level,Mothers against decapentaplegic homolog 2,1,0.9984,5,9,4,9,7,2,4,0,7,2,323333024,84155760,
sp|Q9IBD0|CELF1_DANRE,Q9IBD0,CELF1_DANRE,celf1,501,Danio rerio,1:Experimental evidence at protein level,CUGBP Elav-like family member 1,1,0.999,14,26,26,42,13,13,13,13,21,21,669341440,527678912,
sp|Q9IBD1|CELF3_DANRE,Q9IBD1,CELF3_DANRE,celf3,452,Danio rerio,2:Experimental evidence at transcript level,CUGBP Elav-like family member 3,1,0.999,11,25,16,25,13,12,9,7,13,12,1034403330,1626376060,
sp|Q9MIX8|CYB_DANRE,Q9MIX8,CYB_DANRE,mt-cyb,380,Danio rerio,3:Protein inferred from homology,Cytochrome b,0.8543,0.995,1,3,3,3,2,1,2,1,2,1,59912160,46821964,
sp|Q9MIY0|NU5M_DANRE,Q9MIY0,NU5M_DANRE,mt-nd5,606,Danio rerio,3:Protein inferred from homology,NADH-ubiquinone oxidoreductase chain 5,1,0.999,2,6,6,6,3,3,3,3,3,3,215451360,143118304,
sp|Q9MIY6|ATP8_DANRE,Q9MIY6,ATP8_DANRE,mt-atp8,54,Danio rerio,3:Protein inferred from homology,ATP synthase protein 8,1,0.999,2,8,8,8,4,4,4,4,4,4,761359230,609359230,
sp|Q9MIY7|COX2_DANRE,Q9MIY7,COX2_DANRE,mt-co2,230,Danio rerio,3:Protein inferred from homology,Cytochrome c oxidase subunit 2,1,0.9989,4,22,22,22,11,11,11,11,11,11,1712987390,1109909760,
sp|Q9MIY8|COX1_DANRE,Q9MIY8,COX1_DANRE,mt-co1,516,Danio rerio,2:Experimental evidence at transcript level,Cytochrome c oxidase subunit 1,0.6645,0.97,1,4,4,4,2,2,2,2,2,2,184303280,130325792,
sp|Q9PT92|CATA_DANRE,Q9PT92,CATA_DANRE,cat,526,Danio rerio,2:Experimental evidence at transcript level,Catalase,1,0.999,33,186,172,186,94,92,87,85,94,92,17480474600,13518718000,
sp|Q9PTF3|NDK3_DANRE,Q9PTF3,NDK3_DANRE,nme3,169,Danio rerio,2:Experimental evidence at transcript level,Nucleoside diphosphate kinase 3,1,0.999,10,90,90,90,47,43,47,43,47,43,56512352000,33908609000,
sp|Q9PTP1|PCNA_DANRE,Q9PTP1,PCNA_DANRE,pcna,260,Danio rerio,1:Experimental evidence at protein level,Proliferating cell nuclear antigen,1,0.999,22,143,143,143,80,63,80,63,80,63,20386420700,13183555600,
sp|Q9PTS2|DCUP_DANRE,Q9PTS2,DCUP_DANRE,urod,369,Danio rerio,1:Experimental evidence at protein level,Uroporphyrinogen decarboxylase,1,0.999,19,75,75,75,39,36,39,36,39,36,5541123600,2571004420,
sp|Q9PU58|NIPS2_DANRE,Q9PU58,NIPS2_DANRE,nipsnap2,286,Danio rerio,2:Experimental evidence at transcript level,Protein NipSnap homolog 2,1,0.999,11,30,30,30,15,15,15,15,15,15,2029810180,1702415870,
sp|Q9PUB8|S39A7_DANRE,Q9PUB8,S39A7_DANRE,slc39a7,444,Danio rerio,2:Experimental evidence at transcript level,Zinc transporter Slc39a7,1,0.9983,2,7,7,7,5,2,5,2,5,2,192227104,187952288,
sp|Q9PUE4|COPG2_DANRE,Q9PUE4,COPG2_DANRE,copg2,873,Danio rerio,2:Experimental evidence at transcript level,Coatomer subunit gamma-2,1,0.999,42,127,127,127,72,55,72,55,72,55,8333273100,5447069700,
sp|Q9PV90|RLA0_DANRE,Q9PV90,RLA0_DANRE,rplp0,319,Danio rerio,2:Experimental evidence at transcript level,Large ribosomal subunit protein uL10,1,0.999,19,127,127,127,61,66,61,66,61,66,13015310300,8547329000,
sp|Q9PVF7|PLAKA_DANRE,Q9PVF7,PLAKA_DANRE,jupa,729,Danio rerio,1:Experimental evidence at protein level,Junction plakoglobin a,1,0.999,30,56,56,75,37,19,37,19,47,28,4128262660,1682591490,
sp|Q9PVF8|CTNA1_DANRE,Q9PVF8,CTNA1_DANRE,ctnna1,907,Danio rerio,1:Experimental evidence at protein level,Catenin alpha-1,1,0.999,58,279,223,279,148,131,121,102,148,131,39478628000,22474510300,
sp|Q9PVK4|LDHBA_DANRE,Q9PVK4,LDHBA_DANRE,ldhba,334,Danio rerio,2:Experimental evidence at transcript level,L-lactate dehydrogenase B-A chain,1,0.999,29,764,283,764,404,360,154,129,404,360,264884437000,191626035000,
sp|Q9PVK5|LDHA_DANRE,Q9PVK5,LDHA_DANRE,ldha,333,Danio rerio,2:Experimental evidence at transcript level,L-lactate dehydrogenase A chain,1,0.999,28,431,431,539,231,200,231,200,284,255,137704358000,89421914000,
sp|Q9PW80|IF2B3_DANRE,Q9PW80,IF2B3_DANRE,igf2bp3,582,Danio rerio,1:Experimental evidence at protein level,Insulin-like growth factor 2 mRNA-binding protein 3,1,0.999,35,138,138,178,75,63,75,63,94,84,14529815600,9488388100,
sp|Q9W6A5|OPSG1_DANRE,Q9W6A5,OPSG1_DANRE,opn1mw1,349,Danio rerio,1:Experimental evidence at protein level,Green-sensitive opsin-1,1,0.999,6,37,4,37,16,21,2,2,16,21,3108987650,2016005760,
sp|Q9W6A8|OP1S2_DANRE,Q9W6A8,OP1S2_DANRE,opn1sw2,354,Danio rerio,1:Experimental evidence at protein level,"Opsin-1, short-wave-sensitive 2",1,0.999,3,16,16,16,8,8,8,8,8,8,1095581310,459982720,
sp|Q9W6A9|OP1S1_DANRE,Q9W6A9,OP1S1_DANRE,opn1sw1,336,Danio rerio,1:Experimental evidence at protein level,"Opsin-1, short-wave-sensitive 1",1,0.999,12,137,137,137,64,73,64,73,64,73,16486648800,13852906500,
sp|Q9W6H5|UBC9A_DANRE,Q9W6H5,UBC9A_DANRE,ube2ia,158,Danio rerio,1:Experimental evidence at protein level,SUMO-conjugating enzyme UBC9-A,1,0.999,9,64,9,64,34,30,4,5,34,30,3454060030,3409164290,
sp|Q9W6T7|PSN1_DANRE,Q9W6T7,PSN1_DANRE,psen1,456,Danio rerio,1:Experimental evidence at protein level,Presenilin-1,0.6052,0.9812,1,1,1,1,1,0,1,0,1,0,42597260,0,
sp|Q9W735|PRM1A_DANRE,Q9W735,PRM1A_DANRE,prom1a,826,Danio rerio,2:Experimental evidence at transcript level,Prominin-1-A,0.9983,0.999,3,4,4,4,3,1,3,1,3,1,89338840,15273070,
sp|Q9W740|NOGG2_DANRE,Q9W740,NOGG2_DANRE,nog2,212,Danio rerio,2:Experimental evidence at transcript level,Noggin-2,0.723,0.9805,2,2,2,2,2,0,2,0,2,0,190083968,0,
sp|Q9W762|TIM9_DANRE,Q9W762,TIM9_DANRE,timm9,84,Danio rerio,3:Protein inferred from homology,Mitochondrial import inner membrane translocase subunit Tim9,1,0.999,4,13,13,13,9,4,9,4,9,4,1386351870,233711776,
sp|Q9W7R3|TEN4_DANRE,Q9W7R3,TEN4_DANRE,tenm4,2824,Danio rerio,2:Experimental evidence at transcript level,Teneurin-4,1,0.9901,8,9,9,10,6,3,6,3,7,3,554576580,97707952,
sp|Q9W7R4|TEN3_DANRE,Q9W7R4,TEN3_DANRE,tenm3,2694,Danio rerio,2:Experimental evidence at transcript level,Teneurin-3,1,0.9942,13,21,20,21,11,10,10,10,11,10,7154552800,4259456260,
sp|Q9YH92|CLD7B_DANRE,Q9YH92,CLD7B_DANRE,cldn7b,215,Danio rerio,2:Experimental evidence at transcript level,Claudin-7-B,0.9832,0.9967,1,5,5,5,2,3,2,3,2,3,336048384,225774528,
sp|Q9YHE8|T7L1A_DANRE,Q9YHE8,T7L1A_DANRE,tcf7l1a,560,Danio rerio,1:Experimental evidence at protein level,Transcription factor 7-like 1-A,0.7165,0.9731,2,3,2,3,2,1,1,1,2,1,136499168,1265666.9,
sp|Q9YHX4|SEM4E_DANRE,Q9YHX4,SEM4E_DANRE,sema4e,766,Danio rerio,2:Experimental evidence at transcript level,Semaphorin-4E,1,0.9978,4,5,5,5,3,2,3,2,3,2,159654544,6230105.5,
sp|X1WE18|KANK2_DANRE,X1WE18,KANK2_DANRE,kank2,1085,Danio rerio,3:Protein inferred from homology,KN motif and ankyrin repeat domain-containing protein 2,1,0.999,6,9,9,9,6,3,6,3,6,3,276172032,116829728,
sp|X1WER2|UBA5_DANRE,X1WER2,UBA5_DANRE,uba5,398,Danio rerio,3:Protein inferred from homology,Ubiquitin-like modifier-activating enzyme 5,1,0.998,6,9,9,9,4,5,4,5,4,5,232346400,1345861120,
sp|X1WGX5|PUM3_DANRE,X1WGX5,PUM3_DANRE,pum3,629,Danio rerio,2:Experimental evidence at transcript level,Pumilio homolog 3,0.9997,0.999,4,4,4,4,3,1,3,1,3,1,74039480,129560416,
